阿姨	ayi
足额	zue
恶意	eyi
额度	edu
自己	ziji
可以	keyi
第一	diyi
必须	bixu
如何	ruhe
以及	yiji
继续	jixu
一起	yiqi
那么	name
其他	qita
意义	yiyi
努力	nuli
地区	diqu
如此	ruci
无法	wufa
几乎	jihu
不可	buke
企业	qiye
法律	falv
服务	fuwu
目的	mudi
似乎	sihu
妇女	funv
儿子	erzi
那里	nali
具体	juti
立即	liji
不得	bude
积极	jiji
巨大	juda
取得	qude
负责	fuze
利益	liyi
也许	yexu
女子	nvzi
不足	buzu
日子	rizi
女儿	nver
复杂	fuza
科技	keji
那个	nage
父母	fumu
独立	duli
妈妈	mama
各地	gedi
合理	heli
业务	yewu
速度	sudu
集体	jiti
体系	tixi
毕业	biye
比如	biru
符合	fuhe
打击	daji
鼓励	guli
体育	tiyu
大力	dali
自我	ziwo
各个	gege
特色	tese
给予	jiyu
得了	dele
把握	bawo
一日	yiri
西部	xibu
绿色	lvse
压力	yali
依法	yifa
各自	gezi
基地	jidi
武器	wuqi
大陆	dalu
衣服	yifu
爸爸	baba
区域	quyu
日期	riqi
突破	tupo
资格	zige
距离	juli
意思	yisi
记得	jide
日益	riyi
义务	yiwu
比例	bili
大地	dadi
戏剧	xiju
依据	yiju
土地	tudi
例如	liru
妻子	qizi
立法	lifa
发达	fada
不必	bubi
记录	jilu
力度	lidu
司法	sifa
立刻	like
其次	qici
合法	hefa
克服	kefu
彼此	bici
予以	yuyi
大批	dapi
打破	dapo
仔细	zixi
个体	geti
思路	silu
司机	siji
课题	keti
发布	fabu
子女	zinv
独特	dute
纪律	jilv
无疑	wuyi
秘密	mimi
记忆	jiyi
玻璃	boli
刺激	ciji
估计	guji
哪儿	naer
得以	deyi
步伐	bufa
故意	guyi
袭击	xiji
巴黎	bali
一律	yilv
陆续	luxu
普及	puji
一路	yilu
客户	kehu
合格	hege
极其	jiqi
呼吁	huyu
其余	qiyu
地理	dili
夫妇	fufu
预计	yuji
垃圾	laji
爷爷	yeye
大局	daju
旅客	lvke
纳入	naru
物资	wuzi
热爱	reai
格局	geju
夫妻	fuqi
预测	yuce
娱乐	yule
儿女	ernv
不顾	bugu
埃及	aiji
可惜	kexi
激励	jili
呼吸	huxi
肚子	duzi
顾客	guke
玉米	yumi
富裕	fuyu
而已	eryi
企图	qitu
布局	buju
鼓舞	guwu
据悉	juxi
媳妇	xifu
可怕	kepa
默默	momo
季度	jidu
不安	buan
喜爱	xiai
组合	zuhe
可爱	keai
大都	dadu
马路	malu
抵达	dida
低于	diyu
弟弟	didi
鼻子	bizi
金额	jine
不利	buli
发起	faqi
激发	jifa
许可	xuke
局部	jubu
大哥	dage
福利	fuli
遏制	ezhi
特区	tequ
一体	yiti
皮肤	pifu
立足	lizu
戏曲	xiqu
足以	zuyi
业绩	yeji
不易	buyi
特大	teda
物理	wuli
脖子	bozi
气息	qixi
寂寞	jimo
无不	wubu
模糊	mohu
夜里	yeli
路子	luzi
一度	yidu
发育	fayu
此刻	cike
椅子	yizi
议案	yian
奇迹	qiji
大气	daqi
聚集	juji
歌曲	gequ
大幅	dafu
互利	huli
利于	liyu
恶化	ehua
希腊	xila
胳膊	gebo
大爷	daye
科普	kepu
隔离	geli
八一	bayi
利率	lilv
不及	buji
地图	ditu
业余	yeyu
七一	qiyi
批发	pifa
罢了	bale
脾气	piqi
恶劣	elie
即可	jike
合资	hezi
何必	hebi
预期	yuqi
督促	ducu
气体	qiti
屁股	pigu
日趋	riqu
力气	liqi
大户	dahu
昔日	xiri
礼物	liwu
例子	lizi
无比	wubi
厘米	limi
渔业	yuye
客气	keqi
模拟	moni
幅度	fudu
阻碍	zuai
孤独	gudu
压迫	yapo
库区	kuqu
速递	sudi
日记	riji
闭幕	bimu
取缔	qudi
起诉	qisu
题目	timu
答案	daan
起步	qibu
娃娃	wawa
胡子	huzi
婆婆	popo
大于	dayu
糊涂	hutu
偶尔	ouer
哪怕	napa
利息	lixi
特意	teyi
何以	heyi
突发	tufa
哈哈	haha
拉萨	lasa
密度	midu
步入	buru
父子	fuzi
份额	fene
启发	qifa
土司	tusi
机组	jizu
弥补	mibu
歌舞	gewu
物体	wuti
爱护	aihu
法子	fazi
起码	qima
提议	tiyi
赌博	dubo
复苏	fusu
譬如	piru
不惜	buxi
录取	luqu
剧目	jumu
叶子	yezi
数额	shue
地步	dibu
自发	zifa
披露	pilu
暗暗	anan
目录	mulu
医护	yihu
裤子	kuzi
次日	ciri
提拔	tiba
提取	tiqu
体力	tili
大部	dabu
大妈	dama
普法	pufa
德育	deyu
刻苦	keku
女足	nvzu
子弟	zidi
案子	anzi
日夜	riye
起伏	qifu
罪恶	zuie
不服	bufu
物业	wuye
自律	zilv
互补	hubu
吸纳	xina
祖父	zufu
此地	cidi
密集	miji
读物	duwu
陆地	ludi
固体	guti
依次	yici
绿地	lvdi
离去	liqu
如一	ruyi
法案	faan
案例	anli
急剧	jiju
集资	jizi
立体	liti
序幕	xumu
泥土	nitu
喇叭	laba
液体	yeti
足迹	zuji
集合	jihe
弟子	dizi
女婿	nvxu
业已	yeyi
大体	dati
如期	ruqi
无辜	wugu
压抑	yayi
纳米	nami
湖泊	hupo
朴素	pusu
抚摸	fumo
大米	dami
特地	tedi
习俗	xisu
隔壁	gebi
句子	juzi
大坝	daba
汲取	jiqu
侮辱	wuru
体积	tiji
堵塞	duse
特务	tewu
意图	yitu
乐趣	lequ
入户	ruhu
孤儿	guer
虚拟	xuni
突击	tuji
西欧	xiou
大衣	dayi
细则	xize
比喻	biyu
大字	dazi
自立	zili
题词	tici
打发	dafa
发热	fare
笔记	biji
顾虑	gulv
何不	hebu
故居	guju
也罢	yeba
哎呀	aiya
密码	mima
祖母	zumu
额头	etou
菩萨	pusa
乐意	leyi
吸毒	xidu
哭泣	kuqi
无私	wusi
抵押	diya
配额	peie
阻力	zuli
得力	deli
笔墨	bimo
即日	jiri
俘虏	fulu
辜负	gufu
蚂蚁	mayi
余地	yudi
疙瘩	geda
目睹	mudu
曲艺	quyi
摩擦	moca
葫芦	hulu
舞剧	wuju
一侧	yice
麻木	mamu
户籍	huji
法则	faze
提速	tisu
入伍	ruwu
鸭子	yazi
母子	muzi
疾苦	jiku
细腻	xini
一二	yier
无须	wuxu
奇特	qite
瓦斯	wasi
大肆	dasi
杂技	zaji
兔子	tuzi
误区	wuqu
颗粒	keli
瀑布	pubu
据此	juci
乐得	lede
语法	yufa
袜子	wazi
铺子	puzi
苦苦	kuku
邪恶	xiee
合乎	hehu
易于	yiyu
妓女	jinv
启迪	qidi
热气	reqi
恶心	exin
乐于	leyu
自古	zigu
破案	poan
疫区	yiqu
忽而	huer
步子	buzi
母女	munv
腹地	fudi
牧区	muqu
异地	yidi
夜色	yese
科目	kemu
自私	zisi
继而	jier
气力	qili
不敌	budi
毅力	yili
肚皮	dupi
歌词	geci
按摩	anmo
入库	ruku
私利	sili
姑母	gumu
大喜	daxi
力图	litu
屡屡	lvlv
暗地	andi
麻子	mazi
积压	jiya
急促	jicu
入股	rugu
思绪	sixu
激素	jisu
细雨	xiyu
讴歌	ouge
马驹	maju
紫色	zise
字母	zimu
徐徐	xuxu
祭祀	jisi
西亚	xiya
复议	fuyi
奥秘	aomi
各异	geyi
募集	muji
私自	sizi
和睦	hemu
呕吐	outu
自如	ziru
高额	gaoe
不合	buhe
儿媳	erxi
沐浴	muyu
低迷	dimi
机密	jimi
姨妈	yima
屈服	qufu
姑姑	gugu
喇嘛	lama
拨打	boda
博得	bode
耶稣	yesu
颇具	poju
躯体	quti
足足	zuzu
居于	juyu
可取	kequ
薄荷	bohe
特级	teji
乌鸦	wuya
哎哟	aiyo
合计	heji
木刻	muke
气魄	qipo
腹部	fubu
伯伯	bobo
苦涩	kuse
洗礼	xili
个案	gean
鼻涕	biti
词语	ciyu
默契	moqi
自语	ziyu
把戏	baxi
地热	dire
低级	diji
屡次	lvci
低谷	digu
额外	ewai
可不	kebu
瓷器	ciqi
思议	siyi
速率	sulv
谷子	guzi
拨付	bofu
可恶	kewu
和气	heqi
何故	hegu
旅途	lvtu
河岸	hean
殴打	ouda
屈辱	quru
彝族	yizu
特许	texu
绿叶	lvye
自居	ziju
气压	qiya
大漠	damo
胡须	huxu
莫大	moda
伯母	bomu
曲子	quzi
夜幕	yemu
按期	anqi
何苦	heku
医德	yide
差额	chae
大伯	dabo
蘑菇	mogu
欺侮	qiwu
复辟	fubi
摸底	modi
和服	hefu
怒气	nuqi
个儿	geer
聚居	juju
不辞	buci
姑妈	guma
司马	sima
肃穆	sumu
八字	bazi
马虎	mahu
苏区	suqu
琵琶	pipa
赌气	duqi
历次	lici
已故	yigu
复习	fuxi
一如	yiru
器具	qiju
苛刻	keke
择业	zeye
麻痹	mabi
碧绿	bilv
逼迫	bipo
乏力	fali
莫不	mobu
副业	fuye
率部	lvbu
案发	anfa
路基	luji
篱笆	liba
崎岖	qiqu
耳目	ermu
侧记	ceji
骨骼	guge
野马	yema
议和	yihe
故土	gutu
提法	tifa
无几	wuji
大笔	dabi
魄力	poli
咕噜	gulu
贺词	heci
肌肤	jifu
击毙	jibi
不无	buwu
徒步	tubu
比拟	bini
薄膜	bomo
发芽	faya
褐色	hese
哑巴	yaba
暮色	muse
区区	ququ
和蔼	heai
洗涤	xidi
西医	xiyi
尼姑	nigu
闭塞	bise
地皮	dipi
古朴	gupu
热土	retu
低矮	diai
色泽	seze
得体	deti
谷地	gudi
以西	yixi
波及	boji
奴婢	nubi
爱惜	aixi
巨幅	jufu
语录	yulu
庇护	bihu
我们	women
他们	tamen
问题	wenti
这个	zhege
一些	yixie
起来	qilai
许多	xuduo
如果	ruguo
需要	xuyao
为了	weile
历史	lishi
而且	erqie
这里	zheli
孩子	haizi
特别	tebie
得到	dedao
日本	riben
因此	yinci
对于	duiyu
干部	ganbu
一切	yiqie
大家	dajia
组织	zuzhi
由于	youyu
艺术	yishu
一直	yizhi
学习	xuexi
所以	suoyi
办法	banfa
一般	yiban
以后	yihou
那些	naxie
有的	youde
怎么	zenme
任何	renhe
然而	raner
书记	shuji
个人	geren
不仅	bujin
会议	huiyi
民族	minzu
你们	nimen
注意	zhuyi
进入	jinru
计划	jihua
世纪	shiji
具有	juyou
文艺	wenyi
事业	shiye
汽车	qiche
技术	jishu
记者	jizhe
以来	yilai
觉得	juede
于是	yushi
人物	renwu
这么	zheme
大学	daxue
不过	buguo
时期	shiqi
根据	genju
机会	jihui
科学	kexue
提高	tigao
可是	keshi
引起	yinqi
责任	zeren
部队	budui
部分	bufen
母亲	muqin
保护	baohu
理论	lilun
处理	chuli
地位	diwei
除了	chule
主席	zhuxi
其实	qishi
意识	yishi
自由	ziyou
达到	dadao
态度	taidu
改革	gaige
不是	bushi
回答	huida
一下	yixia
如今	rujin
父亲	fuqin
国际	guoji
理解	lijie
心理	xinli
下去	xiaqu
获得	huode
之一	zhiyi
也是	yeshi
安排	anpai
伟大	weida
制度	zhidu
下午	xiawu
尤其	youqi
部门	bumen
离开	likai
基础	jichu
基本	jiben
考虑	kaolv
不再	buzai
语言	yuyan
分析	fenxi
合作	hezuo
发出	fachu
突然	turan
队伍	duiwu
家里	jiali
采取	caiqu
结合	jiehe
道德	daode
进步	jinbu
道路	daolu
迅速	xunsu
信息	xinxi
发挥	fahui
读者	duzhe
来自	laizi
设计	sheji
恢复	huifu
属于	shuyu
满足	manzu
自然	ziran
投资	touzi
法国	faguo
过去	guoqu
比赛	bisai
开发	kaifa
不知	buzhi
大会	dahui
扩大	kuoda
即使	jishi
难以	nanyi
必要	biyao
特殊	teshu
无论	wulun
机构	jigou
以为	yiwei
分子	fenzi
资金	zijin
祖国	zuguo
不但	budan
投入	touru
高度	gaodu
因素	yinsu
德国	deguo
失去	shiqu
促进	cujin
价格	jiage
值得	zhide
突出	tuchu
错误	cuowu
此外	ciwai
满意	manyi
在于	zaiyu
物质	wuzhi
缺乏	quefa
飞机	feiji
文字	wenzi
严格	yange
依然	yiran
出发	chufa
必然	biran
附近	fujin
体制	tizhi
加入	jiaru
各国	geguo
职业	zhiye
参与	canyu
男子	nanzi
出去	chuqu
规律	guilv
打开	dakai
内部	neibu
夫人	furen
居民	jumin
不久	bujiu
故事	gushi
维护	weihu
规模	guimo
铁路	tielu
到底	daodi
热烈	relie
彻底	chedi
素质	suzhi
美丽	meili
机制	jizhi
再次	zaici
因而	yiner
客人	keren
印度	yindu
那时	nashi
吸引	xiyin
亲自	qinzi
自觉	zijue
处于	chuyu
敌人	diren
逐步	zhubu
加以	jiayi
读书	dushu
早已	zaoyi
舞台	wutai
理由	liyou
有力	youli
大约	dayue
持续	chixu
秩序	zhixu
密切	miqie
今日	jinri
道理	daoli
需求	xuqiu
大事	dashi
贸易	maoyi
旅游	lvyou
拒绝	jujue
高级	gaoji
模式	moshi
势力	shili
配合	peihe
主体	zhuti
河南	henan
严肃	yansu
污染	wuran
至于	zhiyu
地下	dixia
别的	biede
举办	juban
此时	cishi
博士	boshi
科研	keyan
协议	xieyi
决策	juece
核心	hexin
依靠	yikao
似的	shide
允许	yunxu
节目	jiemu
时刻	shike
一套	yitao
多么	duome
足球	zuqiu
思考	sikao
出席	chuxi
熟悉	shuxi
否则	fouze
趋势	qushi
法制	fazhi
不错	bucuo
休息	xiuxi
的确	dique
数字	shuzi
设立	sheli
资本	ziben
地球	diqiu
办理	banli
多次	duoci
女人	nvren
系列	xilie
事故	shigu
法规	fagui
数据	shuju
气氛	qifen
加大	jiada
女士	nvshi
激烈	jilie
执法	zhifa
友谊	youyi
回去	huiqu
负担	fudan
就业	jiuye
看法	kanfa
职务	zhiwu
发言	fayan
以外	yiwai
树立	shuli
忽然	huran
律师	lvshi
这儿	zheer
媒体	meiti
治理	zhili
基金	jijin
气候	qihou
思维	siwei
初步	chubu
反而	faner
做法	zuofa
大概	dagai
反复	fanfu
违法	weifa
男女	nannv
部署	bushu
位于	weiyu
学科	xueke
武汉	wuhan
既然	jiran
大门	damen
十一	shiyi
具备	jubei
他人	taren
人大	renda
色彩	secai
腐败	fubai
事务	shiwu
危机	weiji
规则	guize
紧急	jinji
机械	jixie
和谐	hexie
由此	youci
治安	zhian
栏目	lanmu
利润	lirun
湖南	hunan
文物	wenwu
社区	shequ
舞蹈	wudao
积累	jilei
杂志	zazhi
非法	feifa
温度	wendu
类似	leisi
古代	gudai
爱国	aiguo
活力	huoli
大队	dadui
无数	wushu
货币	huobi
西北	xibei
舆论	yulun
紧密	jinmi
好几	haoji
阶级	jieji
职责	zhize
个别	gebie
各界	gejie
培育	peiyu
分布	fenbu
澳门	aomen
话题	huati
毫无	haowu
内地	neidi
角色	juese
医学	yixue
富有	fuyou
财富	caifu
之际	zhiji
林业	linye
草案	caoan
渠道	qudao
议会	yihui
不论	bulun
考核	kaohe
体会	tihui
扶贫	fupin
头发	toufa
外资	waizi
有机	youji
群体	qunti
安置	anzhi
差距	chaju
咨询	zixun
决议	jueyi
确立	queli
河北	hebei
区别	qubie
大胆	dadan
作业	zuoye
预报	yubao
自主	zizhu
适合	shihe
基因	jiyin
体验	tiyan
游客	youke
支付	zhifu
移民	yimin
居住	juzhu
祝贺	zhuhe
严厉	yanli
节日	jieri
难题	nanti
湖北	hubei
大多	daduo
一带	yidai
极为	jiwei
拉开	lakai
局势	jushi
流域	liuyu
货物	huowu
格外	gewai
发射	fashe
人格	renge
翻译	fanyi
模范	mofan
游戏	youxi
热闹	renao
脱离	tuoli
人次	renci
此后	cihou
居然	juran
人体	renti
绿化	lvhua
旗帜	qizhi
到达	daoda
难得	nande
细胞	xibao
分离	fenli
一口	yikou
安徽	anhui
骨干	gugan
扶持	fuchi
笔者	bizhe
财务	caiwu
累计	leiji
总额	zonge
麻烦	mafan
期待	qidai
题材	ticai
开幕	kaimu
加速	jiasu
开辟	kaipi
大夫	daifu
师傅	shifu
待遇	daiyu
副刊	fukan
南部	nanbu
本地	bendi
人力	renli
爆发	baofa
注册	zhuce
军区	junqu
古老	gulao
害怕	haipa
秘书	mishu
补贴	butie
白色	baise
批判	pipan
付出	fuchu
地质	dizhi
图书	tushu
大人	daren
要素	yaosu
覆盖	fugai
老婆	laopo
可靠	kekao
举措	jucuo
差异	chayi
日报	ribao
药物	yaowu
或许	huoxu
而言	eryan
如下	ruxia
引发	yinfa
颁布	banbu
季节	jijie
离婚	lihun
列入	lieru
高于	gaoyu
代替	daiti
黑暗	heian
外地	waidi
西南	xinan
走私	zousi
沙漠	shamo
足够	zugou
遗憾	yihan
合适	heshi
顾问	guwen
促使	cushi
济南	jinan
与会	yuhui
透露	toulu
国土	guotu
北部	beibu
班子	banzi
迫切	poqie
随即	suiji
暴力	baoli
宿舍	sushe
会晤	huiwu
为何	weihe
议论	yilun
不下	buxia
辐射	fushe
耳朵	erduo
过渡	guodu
可谓	kewei
大赛	dasai
一流	yiliu
至此	zhici
得知	dezhi
忽视	hushi
口气	kouqi
医药	yiyao
外部	waibu
私人	siren
为期	weiqi
一道	yidao
出色	chuse
遭遇	zaoyu
记载	jizai
初期	chuqi
偶然	ouran
近期	jinqi
回顾	huigu
自治	zizhi
举报	jubao
获悉	huoxi
早日	zaori
黑色	heise
高速	gaosu
难度	nandu
厉害	lihai
塑造	suzao
亲戚	qinqi
阅读	yuedu
悲剧	beiju
夺得	duode
有序	youxu
安慰	anwei
所得	suode
自信	zixin
一再	yizai
概率	gailv
随意	suiyi
依旧	yijiu
预备	yubei
暴露	baolu
大海	dahai
逻辑	luoji
毫不	haobu
过于	guoyu
气温	qiwen
不满	buman
分局	fenju
汉语	hanyu
诗歌	shige
投诉	tousu
脑子	naozi
大街	dajie
物品	wupin
不然	buran
敢于	ganyu
剧本	juben
补助	buzhu
对付	duifu
码头	matou
甘肃	gansu
不由	buyou
安心	anxin
未必	weibi
感激	ganji
无奈	wunai
舒服	shufu
代理	daili
为此	weici
毒品	dupin
单独	dandu
法人	faren
自杀	zisha
大军	dajun
老爷	laoye
印尼	yinni
替代	tidai
邻居	linju
牢固	laogu
民俗	minsu
薄弱	boruo
引入	yinru
早期	zaoqi
尾巴	weiba
丝毫	sihao
进而	jiner
沙发	shafa
夜晚	yewan
也好	yehao
爱心	aixin
认可	renke
地处	dichu
分歧	fenqi
荷兰	helan
有趣	youqu
活泼	huopo
自家	zijia
股份	gufen
固然	guran
办案	banan
依托	yituo
单一	danyi
内阁	neige
帽子	maozi
规矩	guiju
厕所	cesuo
细致	xizhi
学历	xueli
海域	haiyu
就此	jiuci
出路	chulu
树木	shumu
辞职	cizhi
演习	yanxi
吉林	jilin
初级	chuji
测试	ceshi
大楼	dalou
细节	xijie
血液	xueye
自豪	zihao
草地	caodi
太子	taizi
研发	yanfa
夺取	duoqu
注入	zhuru
地带	didai
七月	qiyue
假日	jiari
载体	zaiti
幽默	youmo
球迷	qiumi
叙述	xushu
湿地	shidi
夏季	xiaji
劳务	laowu
姿态	zitai
灾区	zaiqu
废物	feiwu
打造	dazao
蓝色	lanse
挖掘	wajue
愤怒	fennu
河流	heliu
迷信	mixin
人马	renma
民意	minyi
辛苦	xinku
书法	shufa
心思	xinsi
获取	huoqu
对立	duili
无非	wufei
记住	jizhu
稳步	wenbu
作物	zuowu
对比	duibi
体坛	titan
物流	wuliu
老子	laozi
击败	jibai
话剧	huaju
对策	duice
地主	dizhu
喜悦	xiyue
逮捕	daibu
崛起	jueqi
村子	cunzi
户口	hukou
海拔	haiba
核查	hecha
尴尬	ganga
策略	celve
度过	duguo
特有	teyou
起草	qicao
思索	sisuo
混合	hunhe
助理	zhuli
支部	zhibu
高大	gaoda
古人	guren
口岸	kouan
发掘	fajue
热心	rexin
回避	huibi
曲折	quzhe
车子	chezi
担负	danfu
试图	shitu
家具	jiaju
虚假	xujia
务实	wushi
委屈	weiqu
报复	baofu
滋味	ziwei
鸡蛋	jidan
普查	pucha
颜色	yanse
策划	cehua
物价	wujia
大厦	dasha
取代	qudai
历来	lilai
木兰	mulan
号码	haoma
汉子	hanzi
储蓄	chuxu
走路	zoulu
拉美	lamei
购物	gouwu
低头	ditou
四处	sichu
各位	gewei
刊物	kanwu
誉为	yuwei
家族	jiazu
吩咐	fenfu
国企	guoqi
被迫	beipo
老挝	laowo
财力	caili
严密	yanmi
都市	dushi
散发	sanfa
高低	gaodi
爱好	aihao
下发	xiafa
嘴巴	zuiba
考古	kaogu
罗马	luoma
话语	huayu
爱人	airen
木材	mucai
葡萄	putao
拼搏	pinbo
业主	yezhu
叹息	tanxi
悲哀	beiai
设法	shefa
劳模	laomo
播出	bochu
合肥	hefei
大致	dazhi
打扮	daban
犹如	youru
嫂子	saozi
孙子	sunzi
输入	shuru
提问	tiwen
贪污	tanwu
不绝	bujue
按时	anshi
入世	rushi
力求	liqiu
一眼	yiyan
揭露	jielu
帷幕	weimu
万一	wanyi
进取	jinqu
级别	jibie
一新	yixin
要么	yaome
严打	yanda
一头	yitou
一派	yipai
部位	buwei
例外	liwai
迄今	qijin
啤酒	pijiu
老区	laoqu
打下	daxia
再度	zaidu
比分	bifen
尸体	shiti
起头	qitou
造福	zaofu
测绘	cehui
大豆	dadou
含义	hanyi
出资	chuzi
特困	tekun
不懈	buxie
完毕	wanbi
修复	xiufu
牌子	paizi
任期	renqi
气味	qiwei
杜绝	dujue
残酷	canku
入学	ruxue
二者	erzhe
和谈	hetan
品格	pinge
信誉	xinyu
牢记	laoji
林木	linmu
大嫂	dasao
得罪	dezui
痕迹	henji
不堪	bukan
肌肉	jirou
忧虑	youlv
延续	yanxu
折磨	zhemo
进度	jindu
和解	hejie
互助	huzhu
牙齿	yachi
咖啡	kafei
汇率	huilv
频率	pinlv
压缩	yasuo
灰色	huise
某个	mouge
伙子	huozi
备案	beian
反思	fansi
大好	dahao
辅导	fudao
老虎	laohu
而后	erhou
紧迫	jinpo
觉悟	juewu
曼谷	mangu
批示	pishi
伦理	lunli
赛季	saiji
下达	xiada
保安	baoan
驻地	zhudi
客运	keyun
尽力	jinli
疑问	yiwen
祝福	zhufu
后期	houqi
贵族	guizu
暴雨	baoyu
起初	qichu
海岸	haian
佩服	peifu
咳嗽	kesou
采集	caiji
日后	rihou
特刊	tekan
陶瓷	taoci
版次	banci
玩具	wanju
理智	lizhi
介入	jieru
彩色	caise
以内	yinei
好奇	haoqi
时而	shier
半夜	banye
地铁	ditie
有无	youwu
柏林	bolin
救济	jiuji
苦难	kunan
剥削	boxue
探测	tance
外语	waiyu
子弹	zidan
皮鞋	pixie
死者	sizhe
各处	gechu
被子	beizi
耽误	danwu
自在	zizai
骨头	gutou
忽略	hulve
子孙	zisun
亿万	yiwan
品德	pinde
租赁	zulin
河道	hedao
柱子	zhuzi
逃避	taobi
符号	fuhao
华丽	huali
抛弃	paoqi
落户	luohu
分割	fenge
西瓜	xigua
不忍	buren
趣味	quwei
富民	fumin
内需	neixu
老大	laoda
热带	redai
楼梯	louti
婚礼	hunli
体操	ticao
麦子	maizi
流露	liulu
颇为	powei
茶叶	chaye
一番	yifan
只顾	zhigu
卡车	kache
尺度	chidu
高压	gaoya
怕是	pashi
牧民	mumin
鬼子	guizi
干吗	ganma
竭力	jieli
女排	nvpai
剥夺	boduo
革新	gexin
规格	guige
亲密	qinmi
器材	qicai
不解	bujie
味儿	weier
发给	fagei
势必	shibi
外科	waike
低保	dibao
毫米	haomi
越发	yuefa
吸烟	xiyan
美德	meide
渔民	yumin
区分	qufen
修理	xiuli
理财	licai
结局	jieju
十足	shizu
可知	kezhi
辅助	fuzhu
都会	duhui
细菌	xijun
适度	shidu
汉族	hanzu
疲劳	pilao
位居	weiju
语文	yuwen
疑惑	yihuo
学期	xueqi
头儿	touer
摸索	mosuo
歹徒	daitu
残疾	canji
洗澡	xizao
大为	dawei
丫头	yatou
本科	benke
伙计	huoji
下雨	xiayu
改组	gaizu
午饭	wufan
军阀	junfa
大脑	danao
破获	pohuo
苦恼	kunao
海底	haidi
弥漫	miman
开业	kaiye
许久	xujiu
坦克	tanke
部落	buluo
服饰	fushi
陆军	lujun
聚会	juhui
而今	erjin
卧室	woshi
帝国	diguo
蝴蝶	hudie
保姆	baomu
寡妇	guafu
心底	xindi
火炬	huoju
稿子	gaozi
出租	chuzu
南极	nanji
亚军	yajun
贿赂	huilu
心目	xinmu
言语	yanyu
林区	linqu
任意	renyi
迫使	poshi
架子	jiazi
误解	wujie
入侵	ruqin
妹子	meizi
土匪	tufei
器械	qixie
搜集	souji
细心	xixin
驾驭	jiayu
出入	churu
劳力	laoli
散步	sanbu
发作	fazuo
狮子	shizi
可贵	kegui
南亚	nanya
语音	yuyin
蓝图	lantu
头目	toumu
迟疑	chiyi
剧烈	julie
奈何	naihe
次数	cishu
万物	wanwu
好比	haobi
期盼	qipan
肉体	routi
保密	baomi
赤字	chizi
拿下	naxia
汽油	qiyou
吃苦	chiku
解答	jieda
历任	liren
豆腐	doufu
银子	yinzi
提示	tishi
期刊	qikan
伟业	weiye
菊花	juhua
复制	fuzhi
亲热	qinre
衙门	yamen
秋季	qiuji
亲爱	qinai
解读	jiedu
客车	keche
寄托	jituo
好似	haosi
系数	xishu
腊月	layue
淹没	yanmo
恶性	exing
君子	junzi
雷达	leida
得失	deshi
库存	kucun
附加	fujia
采纳	caina
迷人	miren
落地	luodi
遇难	yunan
踏实	tashi
担子	danzi
鱼类	yulei
发财	facai
演绎	yanyi
地板	diban
地道	didao
月底	yuedi
富贵	fugui
集训	jixun
误会	wuhui
外婆	waipo
有毒	youdu
本色	bense
汇集	huiji
一早	yizao
哀悼	aidao
猴子	houzi
运气	yunqi
歪曲	waiqu
诗词	shici
出土	chutu
孕育	yunyu
理会	lihui
地毯	ditan
运河	yunhe
眼皮	yanpi
督办	duban
姿势	zishi
阁下	gexia
沿途	yantu
裙子	qunzi
闺女	guinv
定额	dinge
沿岸	yanan
木头	mutou
本土	bentu
路过	luguo
开局	kaiju
图画	tuhua
地貌	dimao
作案	zuoan
温和	wenhe
礼貌	limao
冶金	yejin
树叶	shuye
金色	jinse
直播	zhibo
黑夜	heiye
路口	lukou
里头	litou
新区	xinqu
剖析	pouxi
看似	kansi
名额	minge
林地	lindi
乐器	yueqi
要不	yaobu
在意	zaiyi
朴实	pushi
仆人	puren
泡沫	paomo
归纳	guina
期货	qihuo
厌恶	yanwu
谱写	puxie
责备	zebei
敦促	duncu
敌对	didui
奔赴	benfu
急切	jiqie
儒家	rujia
礼品	lipin
学子	xuezi
回族	huizu
马车	mache
艺人	yiren
起飞	qifei
排污	paiwu
腐朽	fuxiu
告辞	gaoci
猜测	caice
历代	lidai
木板	muban
壁垒	bilei
威力	weili
热血	rexue
撤离	cheli
躲避	duobi
姊妹	zimei
假期	jiaqi
顽固	wangu
萝卜	luobo
野外	yewai
反击	fanji
低温	diwen
欺诈	qizha
含糊	hanhu
科协	kexie
序列	xulie
自学	zixue
词汇	cihui
古国	guguo
以求	yiqiu
退役	tuiyi
度假	dujia
拘留	juliu
固有	guyou
出具	chuju
瞩目	zhumu
粗糙	cucao
多余	duoyu
锅炉	guolu
莫非	mofei
稽查	jicha
单打	danda
野蛮	yeman
邮局	youju
贩毒	fandu
飞速	feisu
认得	rende
回合	huihe
破旧	pojiu
吆喝	yaohe
笔下	bixia
奔波	benbo
初次	chuci
乐曲	yuequ
近乎	jinhu
就医	jiuyi
揭发	jiefa
驱逐	quzhu
构思	gousi
柔和	rouhe
土豆	tudou
丑恶	choue
隐蔽	yinbi
赞誉	zanyu
积分	jifen
牡丹	mudan
热门	remen
催促	cuicu
敷衍	fuyan
素有	suyou
课本	keben
私下	sixia
加热	jiare
席位	xiwei
大腿	datui
归宿	guisu
大炮	dapao
与否	yufou
国务	guowu
打牌	dapai
开启	kaiqi
蜡烛	lazhu
热泪	relei
特使	teshi
急救	jijiu
峡谷	xiagu
亟待	jidai
本子	benzi
门路	menlu
得分	defen
大有	dayou
接纳	jiena
泥沙	nisha
幼儿	youer
壁画	bihua
配偶	peiou
疲惫	pibei
昨日	zuori
粗暴	cubao
附属	fushu
世俗	shisu
四海	sihai
无人	wuren
古今	gujin
迫害	pohai
阻挠	zunao
家务	jiawu
滑稽	huaji
超额	chaoe
一概	yigai
捕捞	bulao
煤气	meiqi
包机	baoji
固执	guzhi
破除	pochu
金子	jinzi
苦闷	kumen
修路	xiulu
酒吧	jiuba
魔鬼	mogui
后续	houxu
日出	richu
预赛	yusai
气派	qipai
外籍	waiji
大叔	dashu
对子	duizi
岳父	yuefu
纳粹	nacui
到期	daoqi
门户	menhu
住宿	zhusu
叙事	xushi
刻画	kehua
谈及	tanji
自费	zifei
滑坡	huapo
自焚	zifen
限额	xiane
不朽	buxiu
发抖	fadou
赛区	saiqu
欧美	oumei
屠杀	tusha
偷渡	toudu
感悟	ganwu
离休	lixiu
图谋	tumou
列席	liexi
扭曲	niuqu
数码	shuma
互惠	huhui
麻雀	maque
散打	sanda
何在	hezai
呐喊	nahan
喜人	xiren
其人	qiren
饱和	baohe
岛屿	daoyu
傻子	shazi
漫步	manbu
自尊	zizun
呼喊	huhan
袖子	xiuzi
推测	tuice
刀子	daozi
膝盖	xigai
细化	xihua
吃力	chili
虚伪	xuwei
谋取	mouqu
以南	yinan
抉择	jueze
力学	lixue
激活	jihuo
以北	yibei
求得	qiude
该死	gaisi
坎坷	kanke
下巴	xiaba
低价	dijia
积雪	jixue
离家	lijia
新奇	xinqi
祈祷	qidao
渤海	bohai
驱车	quche
无罪	wuzui
此人	ciren
法宝	fabao
文集	wenji
脉搏	maibo
盘子	panzi
投机	touji
分级	fenji
诗句	shiju
掩护	yanhu
只怕	zhipa
侵入	qinru
雷雨	leiyu
可信	kexin
根基	genji
气流	qiliu
鞋子	xiezi
压倒	yadao
地势	dishi
姐夫	jiefu
喜事	xishi
解体	jieti
着呢	zhene
义军	yijun
发泄	faxie
气概	qigai
堆积	duiji
就读	jiudu
涉案	shean
孵化	fuhua
国策	guoce
日月	riyue
云集	yunji
实习	shixi
未卜	weibu
及早	jizao
漆黑	qihei
发誓	fashi
废墟	feixu
轨迹	guiji
夸大	kuada
搏斗	bodou
互为	huwei
汇聚	huiju
默然	moran
楷模	kaimo
锣鼓	luogu
芦苇	luwei
赶赴	ganfu
巨人	juren
录音	luyin
浮躁	fuzao
许诺	xunuo
惋惜	wanxi
淡薄	danbo
破裂	polie
隶属	lishu
坟墓	fenmu
赖以	laiyi
杂文	zawen
四肢	sizhi
肆虐	sinve
译本	yiben
底蕴	diyun
匮乏	kuifa
吃喝	chihe
迷惑	mihuo
火热	huore
独有	duyou
特邀	teyao
舍得	shede
暑期	shuqi
私有	siyou
采伐	caifa
无心	wuxin
逼人	biren
户外	huwai
花儿	huaer
近似	jinsi
难于	nanyu
磕头	ketou
素材	sucai
愚昧	yumei
处以	chuyi
加固	jiagu
随笔	suibi
份儿	fener
硅谷	guigu
礼拜	libai
列举	lieju
昆曲	kunqu
热切	reqie
租界	zujie
机车	jiche
女单	nvdan
落幕	luomu
午后	wuhou
诱发	youfa
白发	baifa
逼近	bijin
河内	henei
好意	haoyi
心爱	xinai
误差	wucha
突围	tuwei
信徒	xintu
格式	geshi
美女	meinv
晚期	wanqi
羽毛	yumao
打捞	dalao
虚心	xuxin
耻辱	chiru
林子	linzi
埋伏	maifu
客流	keliu
左翼	zuoyi
旗袍	qipao
骨髓	gusui
铺设	pushe
大头	datou
破烂	polan
虚构	xugou
住户	zhuhu
牧师	mushi
盆地	pendi
去处	quchu
枯竭	kujie
内陆	neilu
破碎	posui
寻觅	xunmi
国歌	guoge
倒塌	daota
举止	juzhi
后继	houji
索取	suoqu
画册	huace
懒得	lande
稳固	wengu
唾沫	tuomo
主业	zhuye
篮子	lanzi
期满	qiman
运力	yunli
解析	jiexi
窒息	zhixi
反驳	fanbo
质朴	zhipu
厚度	houdu
心意	xinyi
落叶	luoye
督察	ducha
合金	hejin
废弃	feiqi
暗杀	ansha
民法	minfa
推理	tuili
复活	fuhuo
昏迷	hunmi
叛徒	pantu
致死	zhisi
对岸	duian
分泌	fenmi
喝彩	hecai
海区	haiqu
新居	xinju
弯曲	wanqu
愈加	yujia
高祖	gaozu
磨难	monan
裸露	luolu
皮包	pibao
留意	liuyi
天鹅	tiane
野心	yexin
压制	yazhi
读本	duben
燃气	ranqi
血压	xueya
旗号	qihao
嘈杂	caoza
破解	pojie
骨肉	gurou
扣押	kouya
杆子	ganzi
得主	dezhu
分批	fenpi
国库	guoku
督导	dudao
安然	anran
衣襟	yijin
繁育	fanyu
乌云	wuyun
外衣	waiyi
荷花	hehua
爱戴	aidai
贴息	tiexi
果子	guozi
自救	zijiu
内衣	neiyi
炎热	yanre
茶几	chaji
太极	taiji
体贴	titie
驳回	bohui
熄灭	ximie
雪地	xuedi
愉悦	yuyue
复查	fucha
胎儿	taier
特写	texie
搭配	dapei
扑灭	pumie
隐私	yinsi
午餐	wucan
看护	kanhu
费力	feili
烈日	lieri
优雅	youya
耗子	haozi
口子	kouzi
多发	duofa
海里	haili
报答	baoda
林立	linli
芝麻	zhima
夹杂	jiaza
背离	beili
屠宰	tuzai
滋润	zirun
哀求	aiqiu
疏忽	shuhu
渎职	duzhi
轮椅	lunyi
图纸	tuzhi
喜讯	xixun
入口	rukou
摊子	tanzi
侄儿	zhier
友爱	youai
陶冶	taoye
狭隘	xiaai
佳绩	jiaji
棍子	gunzi
距今	jujin
本意	benyi
课外	kewai
适于	shiyu
下榻	xiata
合伙	hehuo
枯燥	kuzao
租金	zujin
来去	laiqu
奶妈	naima
虚弱	xuruo
芭蕾	balei
麻醉	mazui
幕后	muhou
女友	nvyou
国力	guoli
威武	weiwu
宝库	baoku
插入	charu
跋涉	bashe
倒闭	daobi
不待	budai
敌军	dijun
花木	huamu
苦心	kuxin
苦干	kugan
下马	xiama
辞退	citui
打印	dayin
志气	zhiqi
北极	beiji
迷失	mishi
睦邻	mulin
军旅	junlv
笔直	bizhi
女篮	nvlan
过大	guoda
己任	jiren
牧草	mucao
哗啦	huala
突厥	tujue
银幕	yinmu
班级	banji
胡闹	hunao
痴迷	chimi
不愧	bukui
草木	caomu
位子	weizi
爆破	baopo
火把	huoba
就绪	jiuxu
折合	zhehe
答话	dahua
下棋	xiaqi
波澜	bolan
结案	jiean
石窟	shiku
分区	fenqu
驻足	zhuzu
择优	zeyou
跃居	yueju
含蓄	hanxu
退伍	tuiwu
后顾	hougu
耽搁	dange
困苦	kunku
妩媚	wumei
体味	tiwei
波涛	botao
波音	boyin
黑客	heike
乙肝	yigan
糟蹋	zaota
戏台	xitai
孕妇	yunfu
无暇	wuxia
河口	hekou
抚慰	fuwei
内科	neike
心得	xinde
贫乏	pinfa
契丹	qidan
心腹	xinfu
微波	weibo
无耻	wuchi
救护	jiuhu
遗嘱	yizhu
打扰	darao
宾客	binke
叹气	tanqi
被褥	beiru
宛如	wanru
巨头	jutou
夏日	xiari
预感	yugan
不凡	bufan
走马	zouma
口语	kouyu
瓦解	wajie
野菜	yecai
华裔	huayi
依存	yicun
不妥	butuo
着地	zhedi
跑步	paobu
时日	shiri
在即	zaiji
地盘	dipan
必备	bibei
维系	weixi
自谋	zimou
奴才	nucai
屋檐	wuyan
稻谷	daogu
触摸	chumo
大汉	dahan
过滤	guolv
入住	ruzhu
地雷	dilei
剧作	juzuo
锐气	ruiqi
在乎	zaihu
发球	faqiu
民居	minju
缔结	dijie
可耻	kechi
推辞	tuici
左侧	zuoce
包子	baozi
虚报	xubao
四化	sihua
要死	yaosi
刺刀	cidao
毗邻	pilin
体察	ticha
范例	fanli
破灭	pomie
下课	xiake
序言	xuyan
酷暑	kushu
亲笔	qinbi
外币	waibi
直达	zhida
河畔	hepan
土改	tugai
道义	daoyi
推举	tuiju
袭来	xilai
过夜	guoye
汛期	xunqi
摩托	motuo
乌黑	wuhei
乞讨	qitao
夜班	yeban
美誉	meiyu
摇曳	yaoye
假币	jiabi
来历	laili
顽皮	wanpi
纬度	weidu
做客	zuoke
傲慢	aoman
触目	chumu
袋子	daizi
惊愕	jinge
实则	shize
参股	cangu
发呆	fadai
北欧	beiou
给以	geiyi
骨架	gujia
可恨	kehen
打折	dazhe
火炉	huolu
偌大	ruoda
问答	wenda
匣子	xiazi
岳母	yuemu
他指	tazhi
务求	wuqiu
发火	fahuo
气球	qiqiu
史册	shice
奋发	fenfa
学府	xuefu
腐烂	fulan
过热	guore
储户	chuhu
悦耳	yueer
自卑	zibei
发问	fawen
死活	sihuo
台词	taici
无尽	wujin
老弟	laodi
毛驴	maolv
泛起	fanqi
益处	yichu
犯法	fanfa
力作	lizuo
街区	jiequ
严酷	yanku
淡漠	danmo
干涸	ganhe
好戏	haoxi
拘束	jushu
规避	guibi
云雾	yunwu
进发	jinfa
骡子	luozi
卑鄙	beibi
老母	laomu
涉足	shezu
外企	waiqi
译者	yizhe
肢体	zhiti
逃离	taoli
特质	tezhi
学徒	xuetu
血迹	xueji
骨折	guzhe
稀罕	xihan
搁置	gezhi
道具	daoju
脊背	jibei
侵袭	qinxi
雇主	guzhu
惬意	qieyi
西夏	xixia
可悲	kebei
居多	juduo
歪理	waili
垦区	kenqu
归于	guiyu
全额	quane
厮杀	sisha
贪图	tantu
题写	tixie
不甘	bugan
班组	banzu
舅父	jiufu
文科	wenke
燕子	yanzi
无赖	wulai
自查	zicha
故作	guzuo
活佛	huofo
月色	yuese
赫然	heran
淘气	taoqi
羞涩	xiuse
凑合	couhe
引力	yinli
起因	qiyin
逐级	zhuji
初二	chuer
协和	xiehe
骨灰	guhui
修补	xiubu
处死	chusi
军医	junyi
陋习	louxi
没落	moluo
质地	zhidi
介意	jieyi
咋办	zeban
暗淡	andan
离散	lisan
下拨	xiabo
父老	fulao
毫克	haoke
匹配	pipei
野草	yecao
歌谣	geyao
寒气	hanqi
起眼	qiyan
剃头	titou
阅历	yueli
孙女	sunnv
餐具	canju
付给	fugei
延期	yanqi
把门	bamen
格言	geyan
拍打	paida
越野	yueye
打球	daqiu
逆差	nicha
侄女	zhinv
内务	neiwu
一瞥	yipie
异国	yiguo
贫苦	pinku
渡口	dukou
本体	benti
贩子	fanzi
络绎	luoyi
弹劾	tanhe
札记	zhaji
安稳	anwen
次要	ciyao
大作	dazuo
毒害	duhai
茂密	maomi
右侧	youce
约合	yuehe
核桃	hetao
绝迹	jueji
懊悔	aohui
而外	erwai
火速	huosu
临死	linsi
赞许	zanxu
勾勒	goule
酒席	jiuxi
狭义	xiayi
北伐	beifa
乏味	fawei
才子	caizi
跨度	kuadu
阻拦	zulan
可口	kekou
儿时	ershi
发音	fayin
避暑	bishu
插图	chatu
隔绝	gejue
骏马	junma
来客	laike
特派	tepai
液化	yehua
皮带	pidai
吓唬	xiahu
比价	bijia
测验	ceyan
路费	lufei
日均	rijun
洒脱	satuo
乌龟	wugui
杂草	zacao
攀比	panbi
自来	zilai
足下	zuxia
罢休	baxiu
疟疾	nueji
伴侣	banlv
肥沃	feiwo
划拨	huabo
茄子	qiezi
亏得	kuide
轮子	lunzi
未可	weike
没有	meiyou
已经	yijing
这些	zhexie
什么	shenme
社会	shehui
关系	guanxi
因为	yinwei
开始	kaishi
人们	renmen
国家	guojia
一定	yiding
就是	jiushi
人民	renmin
认为	renwei
但是	danshi
可能	keneng
只有	zhiyou
要求	yaoqiu
发现	faxian
文化	wenhua
发展	fazhan
时候	shihou
还是	haishi
公司	gongsi
研究	yanjiu
认识	renshi
十分	shifen
希望	xiwang
虽然	suiran
美国	meiguo
知道	zhidao
一样	yiyang
教育	jiaoyu
经济	jingji
主要	zhuyao
革命	geming
之后	zhihou
参加	canjia
最后	zuihou
所有	suoyou
有些	youxie
解决	jiejue
或者	huozhe
时代	shidai
作品	zuopin
不断	buduan
关于	guanyu
根本	genben
作者	zuozhe
感到	gandao
存在	cunzai
比较	bijiao
单位	danwei
目前	muqian
意见	yijian
只要	zhiyao
文学	wenxue
下来	xialai
人类	renlei
报告	baogao
方法	fangfa
能力	nengli
困难	kunnan
随着	suizhe
全部	quanbu
主任	zhuren
只是	zhishi
左右	zuoyou
利用	liyong
来到	laidao
发表	fabiao
有人	youren
支持	zhichi
包括	baokuo
直接	zhijie
后来	houlai
医院	yiyuan
去年	qunian
那样	nayang
老师	laoshi
新闻	xinwen
容易	rongyi
建立	jianli
然后	ranhou
管理	guanli
保持	baochi
选择	xuanze
反对	fandui
是否	shifou
联系	lianxi
所谓	suowei
老人	laoren
按照	anzhao
机关	jiguan
身体	shenti
别人	bieren
以前	yiqian
价值	jiazhi
结束	jieshu
军事	junshi
统一	tongyi
人才	rencai
感觉	ganjue
事实	shishi
分别	fenbie
矛盾	maodun
安全	anquan
提供	tigong
讨论	taolun
消息	xiaoxi
世界	shijie
举行	juxing
目标	mubiao
一边	yibian
原则	yuanze
结构	jiegou
指出	zhichu
农业	nongye
喜欢	xihuan
最近	zuijin
收入	shouru
愿意	yuanyi
系统	xitong
国内	guonei
和平	heping
解释	jieshi
还有	haiyou
作家	zuojia
回来	huilai
出版	chuban
深入	shenru
台湾	taiwan
留下	liuxia
丰富	fengfu
工业	gongye
音乐	yinyue
期间	qijian
范围	fanwei
总理	zongli
未来	weilai
人口	renkou
军队	jundui
外国	waiguo
热情	reqing
建议	jianyi
作为	zuowei
改造	gaizao
民主	minzhu
批评	piping
出口	chukou
报道	baodao
有时	youshi
深刻	shenke
习惯	xiguan
措施	cuoshi
宣布	xuanbu
资源	ziyuan
领域	lingyu
今后	jinhou
经历	jingli
特点	tedian
位置	weizhi
就要	jiuyao
过来	guolai
地方	difang
破坏	pohuai
看来	kanlai
天气	tianqi
欧洲	ouzhou
普通	putong
当地	dangdi
联合	lianhe
权利	quanli
显得	xiande
自身	zishen
指挥	zhihui
演出	yanchu
设备	shebei
哲学	zhexue
学者	xuezhe
体现	tixian
资料	ziliao
工资	gongzi
儿童	ertong
纷纷	fenfen
产业	chanye
监督	jiandu
优秀	youxiu
动物	dongwu
有所	yousuo
至今	zhijin
普遍	pubian
损失	sunshi
死亡	siwang
名字	mingzi
从而	conger
面积	mianji
本来	benlai
幸福	xingfu
确实	queshi
犯罪	fanzui
报纸	baozhi
不管	buguan
西方	xifang
合同	hetong
空气	kongqi
接着	jiezhe
分配	fenpei
综合	zonghe
标题	biaoti
实在	shizai
公路	gonglu
制造	zhizao
落实	luoshi
局面	jumian
电子	dianzi
方案	fangan
公里	gongli
全体	quanti
推进	tuijin
行业	hangye
某些	mouxie
情绪	qingxu
为主	weizhu
只好	zhihao
规划	guihua
探索	tansuo
房子	fangzi
之外	zhiwai
有着	youzhe
规范	guifan
一面	yimian
案件	anjian
集团	jituan
里面	limian
仿佛	fangfu
国外	guowai
谈话	tanhua
绝对	juedui
小组	xiaozu
导致	daozhi
统计	tongji
连续	lianxu
批准	pizhun
客观	keguan
表达	biaoda
考察	kaocha
学术	xueshu
设施	sheshi
担心	danxin
东西	dongxi
顺利	shunli
引导	yindao
感谢	ganxie
亚洲	yazhou
担任	danren
痛苦	tongku
决心	juexin
路线	luxian
用于	yongyu
森林	senlin
落后	luohou
大型	daxing
主持	zhuchi
结果	jieguo
吃饭	chifan
运输	yunshu
法院	fayuan
食品	shipin
培训	peixun
避免	bimian
接触	jiechu
友好	youhao
老板	laoban
基层	jiceng
奋斗	fendou
大小	daxiao
国有	guoyou
医疗	yiliao
激动	jidong
纪念	jinian
亲切	qinqie
办事	banshi
试验	shiyan
考试	kaoshi
选举	xuanju
街道	jiedao
兴趣	xingqu
改进	gaijin
样子	yangzi
咱们	zanmen
切实	qieshi
从此	congci
一阵	yizhen
威胁	weixie
修改	xiugai
人家	renjia
美好	meihao
引进	yinjin
首都	shoudu
效益	xiaoyi
信心	xinxin
工具	gongju
石油	shiyou
效率	xiaolv
所在	suozai
用户	yonghu
贫困	pinkun
宪法	xianfa
快速	kuaisu
忘记	wangji
失败	shibai
对待	duidai
风格	fengge
推出	tuichu
结婚	jiehun
角度	jiaodu
日前	riqian
跟着	genzhe
临时	linshi
巩固	gonggu
途径	tujing
市民	shimin
疾病	jibing
本质	benzhi
接近	jiejin
团体	tuanti
围绕	weirao
人数	renshu
村民	cunmin
层次	cengci
门口	menkou
计算	jisuan
爱情	aiqing
多数	duoshu
放弃	fangqi
随后	suihou
确保	quebao
到处	daochu
诗人	shiren
动力	dongli
交易	jiaoyi
恐怕	kongpa
红色	hongse
公布	gongbu
维持	weichi
发行	faxing
西藏	xicang
协会	xiehui
购买	goumai
信任	xinren
性格	xingge
总体	zongti
国民	guomin
对话	duihua
条例	tiaoli
学会	xuehui
图片	tupian
难道	nandao
天地	tiandi
慢慢	manman
在内	zainei
人群	renqun
吸收	xishou
仅仅	jinjin
女性	nvxing
内心	neixin
毕竟	bijing
恐怖	kongbu
移动	yidong
操作	caozuo
预防	yufang
快乐	kuaile
研制	yanzhi
编辑	bianji
取消	quxiao
公安	gongan
进来	jinlai
发动	fadong
履行	lvxing
地面	dimian
若干	ruogan
登记	dengji
制作	zhizuo
谈判	tanpan
韩国	hanguo
背后	beihou
蔬菜	shucai
苏联	sulian
资产	zichan
提前	tiqian
之下	zhixia
对外	duiwai
前提	qianti
怀疑	huaiyi
药品	yaopin
等于	dengyu
一行	yixing
随时	suishi
打算	dasuan
启动	qidong
分裂	fenlie
答应	daying
违反	weifan
出来	chulai
军人	junren
接待	jiedai
海外	haiwai
好处	haochu
损害	sunhai
懂得	dongde
汇报	huibao
来信	laixin
人人	renren
要闻	yaowen
遭到	zaodao
开拓	kaituo
善于	shanyu
本人	benren
禁止	jinzhi
人均	renjun
制约	zhiyue
伙伴	huoban
手续	shouxu
会谈	huitan
说法	shuofa
权益	quanyi
到来	daolai
危害	weihai
暂时	zanshi
云南	yunnan
不幸	buxing
房屋	fangwu
家属	jiashu
山区	shanqu
以往	yiwang
品牌	pinpai
清理	qingli
山西	shanxi
可见	kejian
爆炸	baozha
优质	youzhi
优化	youhua
赢得	yingde
论坛	luntan
婚姻	hunyin
石头	shitou
欧盟	oumeng
节约	jieyue
如同	rutong
福建	fujian
一手	yishou
病毒	bingdu
身子	shenzi
太太	taitai
提醒	tixing
真理	zhenli
固定	guding
照顾	zhaogu
审批	shenpi
东部	dongbu
地点	didian
电力	dianli
探讨	tantao
手机	shouji
同期	tongqi
结论	jielun
头脑	tounao
最好	zuihao
活跃	huoyue
最初	zuichu
乃至	naizhi
勇气	yongqi
果然	guoran
著作	zhuzuo
自从	zicong
奇怪	qiguai
眼泪	yanlei
发扬	fayang
艰苦	jianku
轨道	guidao
数学	shuxue
纠纷	jiufen
自动	zidong
耕地	gengdi
保留	baoliu
写作	xiezuo
攻击	gongji
据说	jushuo
潜力	qianli
当局	dangju
预算	yusuan
配套	peitao
出台	chutai
农户	nonghu
听取	tingqu
内涵	neihan
设置	shezhi
摆脱	baituo
进口	jinkou
审议	shenyi
感染	ganran
要是	yaoshi
工艺	gongyi
宝贵	baogui
示范	shifan
检测	jiance
主办	zhuban
土壤	turang
奶奶	nainai
年度	niandu
最佳	zuijia
人心	renxin
查处	chachu
回头	huitou
考验	kaoyan
陷入	xianru
发放	fafang
火车	huoche
开会	kaihui
地震	dizhen
技能	jineng
不用	buyong
带有	daiyou
全局	quanju
法官	faguan
金牌	jinpai
发明	faming
严峻	yanjun
小雨	xiaoyu
截至	jiezhi
组建	zujian
英语	yingyu
分类	fenlei
依照	yizhao
化学	huaxue
凡是	fanshi
无限	wuxian
优惠	youhui
各方	gefang
退休	tuixiu
美术	meishu
夜间	yejian
决赛	juesai
处在	chuzai
泰国	taiguo
倒是	daoshi
变革	biange
越南	yuenan
个性	gexing
委托	weituo
品质	pinzhi
主导	zhudao
配置	peizhi
愉快	yukuai
或是	huoshi
热点	redian
导弹	daodan
南北	nanbei
海军	haijun
保存	baocun
选拔	xuanba
采购	caigou
荣誉	rongyu
姐姐	jiejie
前途	qiantu
定期	dingqi
画家	huajia
院子	yuanzi
最为	zuiwei
论文	lunwen
激情	jiqing
理念	linian
脑袋	naodai
煤炭	meitan
沿着	yanzhe
年底	niandi
好好	haohao
原理	yuanli
侵略	qinlve
神秘	shenmi
概括	gaikuo
沿海	yanhai
诉讼	susong
出门	chumen
妹妹	meimei
档案	dangan
内在	neizai
外来	wailai
列车	lieche
大臣	dachen
询问	xunwen
寻求	xunqiu
可怜	kelian
大厅	dating
极端	jiduan
运作	yunzuo
灾害	zaihai
工地	gongdi
返回	fanhui
理性	lixing
内外	neiwai
此间	cijian
台阶	taijie
处分	chufen
后果	houguo
一方	yifang
治国	zhiguo
判决	panjue
氛围	fenwei
会计	kuaiji
视为	shiwei
老汉	laohan
名义	mingyi
导演	daoyan
疫情	yiqing
协助	xiezhu
报刊	baokan
领土	lingtu
本届	benjie
晚会	wanhui
口号	kouhao
罚款	fakuan
清晰	qingxi
到位	daowei
华人	huaren
审计	shenji
评估	pinggu
年纪	nianji
侵犯	qinfan
水利	shuili
慰问	weiwen
约束	yueshu
桌子	zhuozi
处置	chuzhi
外汇	waihui
保卫	baowei
告别	gaobie
沉默	chenmo
实质	shizhi
渴望	kewang
武警	wujing
一贯	yiguan
水泥	shuini
本事	benshi
授予	shouyu
人文	renwen
论述	lunshu
救助	jiuzhu
带头	daitou
赶紧	ganjin
阵地	zhendi
回归	huigui
信号	xinhao
球队	qiudui
那边	nabian
外出	waichu
宇宙	yuzhou
家人	jiaren
股票	gupiao
制止	zhizhi
分散	fensan
开口	kaikou
处处	chuchu
顿时	dunshi
税务	shuiwu
伦敦	lundun
干涉	ganshe
遵循	zunxun
百万	baiwan
蒙古	menggu
总部	zongbu
眼下	yanxia
之内	zhinei
包含	baohan
信贷	xindai
北约	beiyue
污水	wushui
代价	daijia
岁月	suiyue
着力	zhuoli
街头	jietou
南非	nanfei
法庭	fating
参赛	cansai
盲目	mangmu
一同	yitong
复兴	fuxing
脸色	lianse
服从	fucong
海南	hainan
关闭	guanbi
含有	hanyou
亲人	qinren
外贸	waimao
凝聚	ningju
冬季	dongji
限度	xiandu
水库	shuiku
诸多	zhuduo
办学	banxue
科教	kejiao
欢乐	huanle
支队	zhidui
国会	guohui
小子	xiaozi
脚步	jiaobu
扎实	zhashi
敏感	mingan
晓得	xiaode
期限	qixian
散文	sanwen
问候	wenhou
好事	haoshi
功夫	gongfu
遗产	yichan
谴责	qianze
抬头	taitou
打工	dagong
造林	zaolin
不曾	buceng
提交	tijiao
特定	teding
小区	xiaoqu
受理	shouli
金属	jinshu
赛事	saishi
频繁	pinfan
确认	queren
债务	zhaiwu
后者	houzhe
京剧	jingju
星期	xingqi
前夕	qianxi
周期	zhouqi
监狱	jianyu
绘画	huihua
差别	chabie
期望	qiwang
流失	liushi
担保	danbao
室内	shinei
开设	kaishe
法定	fading
心头	xintou
起身	qishen
好看	haokan
一线	yixian
微微	weiwei
出国	chuguo
算了	suanle
不免	bumian
周末	zhoumo
模样	muyang
违规	weigui
不便	bubian
拍摄	paishe
风力	fengli
破产	pochan
线路	xianlu
干旱	ganhan
谢谢	xiexie
四周	sizhou
淘汰	taotai
干脆	gancui
耐心	naixin
干扰	ganrao
优美	youmei
若是	ruoshi
视察	shicha
肺炎	feiyan
灾难	zainan
支柱	zhizhu
审理	shenli
当即	dangji
贴近	tiejin
福州	fuzhou
招呼	zhaohu
评议	pingyi
灿烂	canlan
家伙	jiahuo
私营	siying
红旗	hongqi
男人	nanren
节奏	jiezou
平安	pingan
司令	siling
课堂	ketang
划分	huafen
便宜	pianyi
骄傲	jiaoao
融合	ronghe
看待	kandai
着急	zhaoji
防御	fangyu
抗日	kangri
东亚	dongya
当日	dangri
亏损	kuisun
感慨	gankai
党组	dangzu
救灾	jiuzai
指数	zhishu
心态	xintai
佛教	fojiao
否认	fouren
便利	bianli
留学	liuxue
景区	jingqu
饲料	siliao
味道	weidao
呼唤	huhuan
化肥	huafei
模型	moxing
好多	haoduo
开办	kaiban
观测	guance
维修	weixiu
占据	zhanju
艰巨	jianju
扩散	kuosan
口袋	koudai
深度	shendu
摇头	yaotou
排除	paichu
被告	beigao
大选	daxuan
下列	xialie
风气	fengqi
民事	minshi
近代	jindai
过分	guofen
影子	yingzi
月份	yuefen
恋爱	lianai
学问	xuewen
签字	qianzi
步骤	buzhou
欧元	ouyuan
开支	kaizhi
伴随	bansui
制品	zhipin
支配	zhipei
抗击	kangji
自行	zixing
短期	duanqi
改制	gaizhi
驻华	zhuhua
发电	fadian
不定	buding
点儿	dianer
少女	shaonv
本国	benguo
准则	zhunze
起点	qidian
六月	liuyue
收益	shouyi
营业	yingye
技巧	jiqiao
收取	shouqu
尊严	zunyan
民办	minban
融资	rongzi
增幅	zengfu
眼看	yankan
应急	yingji
此前	ciqian
警惕	jingti
火灾	huozai
入手	rushou
输出	shuchu
开门	kaimen
有害	youhai
惊讶	jingya
买卖	maimai
干事	ganshi
掀起	xianqi
高考	gaokao
入党	rudang
热线	rexian
婴儿	yinger
难过	nanguo
态势	taishi
旨在	zhizai
帮扶	bangfu
同步	tongbu
不料	buliao
抗议	kangyi
消极	xiaoji
储备	chubei
参考	cankao
发票	fapiao
后勤	houqin
学位	xuewei
安定	anding
制裁	zhicai
华北	huabei
海峡	haixia
珍惜	zhenxi
乐观	leguan
庞大	pangda
一身	yishen
特性	texing
合并	hebing
军民	junmin
姐妹	jiemei
主流	zhuliu
乃是	naishi
纳税	nashui
高温	gaowen
抵抗	dikang
晚饭	wanfan
化解	huajie
看作	kanzuo
水土	shuitu
急忙	jimang
拍卖	paimai
消毒	xiaodu
是非	shifei
研讨	yantao
蔓延	manyan
棋手	qishou
客厅	keting
民心	minxin
镜子	jingzi
跨越	kuayue
推开	tuikai
本月	benyue
配备	peibei
安静	anjing
欲望	yuwang
封闭	fengbi
手法	shoufa
饮食	yinshi
擅自	shanzi
造就	zaojiu
责令	zeling
座谈	zuotan
本着	benzhe
蓬勃	pengbo
助学	zhuxue
片刻	pianke
战役	zhanyi
产物	chanwu
恐惧	kongju
偷偷	toutou
携带	xiedai
加紧	jiajin
缘故	yuangu
应付	yingfu
肩负	jianfu
违背	weibei
后悔	houhui
国人	guoren
不觉	bujiao
开采	kaicai
互动	hudong
必定	biding
叔叔	shushu
塑料	suliao
名誉	mingyu
旅馆	lvguan
点击	dianji
平日	pingri
面子	mianzi
判处	panchu
亲属	qinshu
驾驶	jiashi
无效	wuxiao
病例	bingli
用力	yongli
注视	zhushi
美学	meixue
实惠	shihui
握手	woshou
审核	shenhe
悠久	youjiu
持久	chijiu
侵害	qinhai
文人	wenren
扮演	banyan
越是	yueshi
没收	moshou
举动	judong
无从	wucong
分解	fenjie
构筑	gouzhu
做事	zuoshi
篮球	lanqiu
讨厌	taoyan
化石	huashi
从业	congye
元素	yuansu
占地	zhandi
便于	bianyu
一旁	yipang
花卉	huahui
风雨	fengyu
即便	jibian
纪检	jijian
轻易	qingyi
过后	guohou
开心	kaixin
网吧	wangba
温柔	wenrou
首席	shouxi
炸弹	zhadan
淮河	huaihe
不妨	bufang
不明	buming
里边	libian
借助	jiezhu
增大	zengda
少爷	shaoye
查获	chahuo
太后	taihou
欺骗	qipian
外界	waijie
胡同	hutong
股东	gudong
隧道	suidao
欢喜	huanxi
雕塑	diaosu
深夜	shenye
烈士	lieshi
借口	jiekou
要紧	yaojin
过多	guoduo
任职	renzhi
刑法	xingfa
做人	zuoren
嗓子	sangzi
仅有	jinyou
老鼠	laoshu
达标	dabiao
控股	konggu
心血	xinxue
务工	wugong
饲养	siyang
归来	guilai
完美	wanmei
效力	xiaoli
裁判	caipan
来临	lailin
无聊	wuliao
孔子	kongzi
神气	shenqi
多久	duojiu
诱惑	youhuo
古典	gudian
没事	meishi
淡淡	dandan
海湾	haiwan
植被	zhibei
繁殖	fanzhi
筹集	chouji
在座	zaizuo
家门	jiamen
缴纳	jiaona
值班	zhiban
关爱	guanai
难民	nanmin
行李	xingli
恰恰	qiaqia
狠狠	henhen
后人	houren
下旬	xiaxun
栽培	zaipei
跳舞	tiaowu
可笑	kexiao
发送	fasong
车队	chedui
舒适	shushi
妇联	fulian
言论	yanlun
树林	shulin
昨晚	zuowan
尤为	youwei
大片	dapian
排列	pailie
靠近	kaojin
热潮	rechao
通俗	tongsu
严禁	yanjin
下游	xiayou
下属	xiashu
困扰	kunrao
免疫	mianyi
报社	baoshe
日元	riyuan
进军	jinjun
防护	fanghu
职位	zhiwei
查询	chaxun
作主	zuozhu
频道	pindao
罪犯	zuifan
康复	kangfu
疫苗	yimiao
台北	taibei
门槛	menkan
下班	xiaban
谈论	tanlun
舅舅	jiujiu
巡逻	xunluo
郊区	jiaoqu
农资	nongzi
演奏	yanzou
屏幕	pingmu
打断	daduan
假若	jiaruo
波动	bodong
说服	shuofu
频频	pinpin
妨碍	fangai
参谋	canmou
山坡	shanpo
田野	tianye
死刑	sixing
豪华	haohua
藏族	zangzu
器官	qiguan
多半	duoban
烦恼	fannao
港澳	gangao
领取	lingqu
温饱	wenbao
民国	minguo
设有	sheyou
指引	zhiyin
缓和	huanhe
反馈	fankui
不容	burong
半岛	bandao
开阔	kaikuo
粉碎	fensui
血肉	xuerou
飞跃	feiyue
羡慕	xianmu
无情	wuqing
忙碌	manglu
盗版	daoban
推翻	tuifan
开车	kaiche
仓库	cangku
大风	dafeng
永不	yongbu
学费	xuefei
无形	wuxing
脆弱	cuiruo
出任	churen
河边	hebian
美化	meihua
侧面	cemian
筷子	kuaizi
漫画	manhua
前期	qianqi
克隆	kelong
来回	laihui
春季	chunji
接轨	jiegui
神色	shense
定义	dingyi
调度	diaodu
问世	wenshi
治沙	zhisha
挂牌	guapai
看好	kanhao
感人	ganren
聚焦	jujiao
海口	haikou
预警	yujing
开除	kaichu
恰好	qiahao
反倒	fandao
赞助	zanzhu
老家	laojia
主角	zhujue
识别	shibie
大棚	dapeng
齐全	qiquan
担忧	danyou
分流	fenliu
挫折	cuozhe
为难	weinan
无关	wuguan
纽带	niudai
有待	youdai
负面	fumian
测定	ceding
电器	dianqi
迈进	maijin
宴会	yanhui
公寓	gongyu
昼夜	zhouye
遇见	yujian
女工	nvgong
贺电	hedian
奶牛	nainiu
文书	wenshu
持有	chiyou
欣慰	xinwei
感叹	gantan
跨国	kuaguo
移交	yijiao
安宁	anning
盈利	yingli
对口	duikou
播放	bofang
大战	dazhan
社论	shelun
西洋	xiyang
阴谋	yinmou
照例	zhaoli
历经	lijing
拨款	bokuan
舌头	shetou
一共	yigong
护工	hugong
总的	zongde
骑兵	qibing
南下	nanxia
机电	jidian
讽刺	fengci
辛勤	xinqin
剧团	jutuan
柜台	guitai
惊喜	jingxi
勤奋	qinfen
做饭	zuofan
右派	youpai
起源	qiyuan
名词	mingci
分化	fenhua
用途	yongtu
沙滩	shatan
互访	hufang
地形	dixing
局限	juxian
标语	biaoyu
驻军	zhujun
浓度	nongdu
三国	sanguo
推迟	tuichi
后代	houdai
临近	linjin
再三	zaisan
黑人	heiren
华夏	huaxia
提名	timing
公务	gongwu
色情	seqing
思潮	sichao
繁华	fanhua
眉头	meitou
救治	jiuzhi
手臂	shoubi
摧毁	cuihui
申诉	shensu
揭开	jiekai
心事	xinshi
信赖	xinlai
沉思	chensi
一连	yilian
进化	jinhua
熟人	shuren
源于	yuanyu
雨水	yushui
削弱	xueruo
尽早	jinzao
告知	gaozhi
除非	chufei
温馨	wenxin
玫瑰	meigui
明日	mingri
排队	paidui
白云	baiyun
流泪	liulei
祖先	zuxian
屋顶	wuding
模仿	mofang
预定	yuding
拥挤	yongji
谋求	mouqiu
这般	zheban
外人	wairen
储存	chucun
日渐	rijian
献策	xiance
超级	chaoji
溶液	rongye
构造	gouzao
好久	haojiu
挽救	wanjiu
西宁	xining
少儿	shaoer
勘探	kantan
四面	simian
查办	chaban
下跌	xiadie
核算	hesuan
使劲	shijin
解难	jienan
提请	tiqing
档次	dangci
困惑	kunhuo
免得	miande
书画	shuhua
往日	wangri
官司	guansi
开花	kaihua
入境	rujing
开学	kaixue
书写	shuxie
限于	xianyu
台下	taixia
指南	zhinan
排斥	paichi
挂钩	guagou
岩石	yanshi
剧院	juyuan
文本	wenben
电路	dianlu
灾民	zaimin
好些	haoxie
品位	pinwei
惊奇	jingqi
风俗	fengsu
公仆	gongpu
疲倦	pijuan
命题	mingti
站立	zhanli
眉毛	meimao
发病	fabing
打动	dadong
理顺	lishun
时报	shibao
雪花	xuehua
果树	guoshu
口头	koutou
测评	ceping
宝贝	baobei
伪造	weizao
曲线	quxian
盗窃	daoqie
不平	buping
敬意	jingyi
旋律	xuanlv
慈善	cishan
浓郁	nongyu
别墅	bieshu
股权	guquan
歌手	geshou
完备	wanbei
捍卫	hanwei
购置	gouzhi
牛奶	niunai
填补	tianbu
小路	xiaolu
骆驼	luotuo
预料	yuliao
利税	lishui
视觉	shijue
轮流	lunliu
角逐	juezhu
敏锐	minrui
喜庆	xiqing
改为	gaiwei
火焰	huoyan
亲眼	qinyan
兼顾	jiangu
杀害	shahai
苦笑	kuxiao
假冒	jiamao
路面	lumian
焦急	jiaoji
缺口	quekou
农机	nongji
暑假	shujia
烟草	yancao
本文	benwen
甘心	ganxin
卫士	weishi
掩盖	yangai
游览	youlan
滚滚	gungun
树枝	shuzhi
雪白	xuebai
天子	tianzi
寂静	jijing
潇洒	xiaosa
亲友	qinyou
稳妥	wentuo
赞美	zanmei
欢呼	huanhu
山地	shandi
眼珠	yanzhu
在家	zaijia
退回	tuihui
看台	kantai
告诫	gaojie
好吃	haochi
华南	huanan
黎明	liming
国道	guodao
果实	guoshi
理应	liying
伟人	weiren
干群	ganqun
洋溢	yangyi
优越	youyue
周密	zhoumi
下滑	xiahua
四方	sifang
巡视	xunshi
古怪	guguai
跟随	gensui
水域	shuiyu
总督	zongdu
何等	hedeng
谣言	yaoyan
勤劳	qinlao
二战	erzhan
逃走	taozou
并举	bingju
大洋	dayang
作文	zuowen
参拜	canbai
递交	dijiao
泛滥	fanlan
体面	timian
祖宗	zuzong
脱贫	tuopin
裁决	caijue
弊端	biduan
分支	fenzhi
面目	mianmu
制假	zhijia
税率	shuilv
解散	jiesan
感冒	ganmao
的当	didang
合影	heying
毛巾	maojin
筹资	chouzi
南海	nanhai
可行	kexing
反射	fanshe
毁灭	huimie
抽屉	chouti
山路	shanlu
地段	diduan
退化	tuihua
防疫	fangyi
驱动	qudong
撤出	chechu
敬业	jingye
忍耐	rennai
侵蚀	qinshi
吃亏	chikui
涵盖	hangai
后备	houbei
均匀	junyun
时髦	shimao
特权	tequan
才华	caihua
唯有	weiyou
造反	zaofan
媒介	meijie
醒目	xingmu
文坛	wentan
佳节	jiajie
连夜	lianye
亲近	qinjin
住处	zhuchu
情趣	qingqu
月球	yueqiu
评比	pingbi
馒头	mantou
堕落	duoluo
顺序	shunxu
杂交	zajiao
素养	suyang
指头	zhitou
餐饮	canyin
撤军	chejun
干啥	gansha
残留	canliu
进驻	jinzhu
容纳	rongna
本就	benjiu
空虚	kongxu
遍布	bianbu
字样	ziyang
请客	qingke
出卖	chumai
干燥	ganzao
功课	gongke
搭建	dajian
脱困	tuokun
蓄水	xushui
入选	ruxuan
登陆	denglu
妥协	tuoxie
桃花	taohua
梆子	bangzi
导游	daoyou
信托	xintuo
饺子	jiaozi
扎根	zhagen
确切	queqie
星子	xingzi
健儿	jianer
倒霉	daomei
测算	cesuan
巡回	xunhui
版本	banben
鼓吹	guchui
花朵	huaduo
歌颂	gesong
迁移	qianyi
书包	shubao
诉说	sushuo
景色	jingse
胖子	pangzi
饭碗	fanwan
驻扎	zhuzha
境地	jingdi
秀美	xiumei
过错	guocuo
人道	rendao
沙化	shahua
核准	hezhun
捕捉	buzhuo
录用	luyong
促销	cuxiao
海滨	haibin
赞叹	zantan
在职	zaizhi
体检	tijian
参军	canjun
蛋白	danbai
回落	huiluo
极限	jixian
思念	sinian
把关	baguan
治本	zhiben
秀才	xiucai
焕发	huanfa
交付	jiaofu
不快	bukuai
难堪	nankan
侦破	zhenpo
预先	yuxian
路段	luduan
隐隐	yinyin
用以	yongyi
犯人	fanren
半数	banshu
隐瞒	yinman
出头	chutou
宁可	ningke
首次	shouci
大同	datong
进出	jinchu
下楼	xialou
钦佩	qinpei
注射	zhushe
别处	biechu
在学	zaixue
天色	tianse
新近	xinjin
所致	suozhi
时下	shixia
杯赛	beisai
辫子	bianzi
脑海	naohai
非要	feiyao
解脱	jietuo
深思	shensi
恪守	keshou
出事	chushi
电梯	dianti
战绩	zhanji
洽谈	qiatan
白白	baibai
焦虑	jiaolv
报考	baokao
在外	zaiwai
悲惨	beican
排球	paiqiu
氧气	yangqi
远大	yuanda
计较	jijiao
阻挡	zudang
丢失	diushi
实话	shihua
大潮	dachao
店铺	dianpu
洁白	jiebai
操心	caoxin
立方	lifang
放大	fangda
后退	houtui
执勤	zhiqin
晚报	wanbao
折射	zheshe
搜索	sousuo
鸦片	yapian
平和	pinghe
免去	mianqu
枢纽	shuniu
王爷	wangye
供需	gongxu
乐队	yuedui
镇压	zhenya
唤起	huanqi
饱满	baoman
胚胎	peitai
微弱	weiruo
悠悠	youyou
风度	fengdu
罢免	bamian
宏大	hongda
劣质	liezhi
冷漠	lengmo
姥姥	laolao
下回	xiahui
假设	jiashe
酒杯	jiubei
威信	weixin
辩护	bianhu
饭菜	fancai
排查	paicha
送礼	songli
坐落	zuoluo
下落	xialuo
黑白	heibai
人头	rentou
圈子	quanzi
人流	renliu
露天	lutian
轮廓	lunkuo
大方	dafang
骗取	pianqu
大红	dahong
书本	shuben
大纲	dagang
参数	canshu
警务	jingwu
宣读	xuandu
迟迟	chichi
口吻	kouwen
使者	shizhe
就任	jiuren
山谷	shangu
电压	dianya
地表	dibiao
辣椒	lajiao
谈心	tanxin
功率	gonglv
尽头	jintou
烟花	yanhua
门类	menlei
跻身	jishen
过问	guowen
眼界	yanjie
云云	yunyun
留心	liuxin
察看	chakan
军委	junwei
所属	suoshu
废除	feichu
否决	foujue
货运	huoyun
礼堂	litang
风波	fengbo
万万	wanwan
反弹	fantan
某某	moumou
蛋糕	dangao
核定	heding
外事	waishi
对接	duijie
天体	tianti
我见	wojian
提炼	tilian
爆竹	baozhu
好人	haoren
逃跑	taopao
哆嗦	duosuo
火爆	huobao
亩产	muchan
津贴	jintie
绿洲	lvzhou
精度	jingdu
热水	reshui
萎缩	weisuo
抗拒	kangju
虐待	nuedai
喃喃	nannan
非凡	feifan
搬家	banjia
疫病	yibing
后门	houmen
高贵	gaogui
嫌疑	xianyi
早晚	zaowan
拖延	tuoyan
交替	jiaoti
陶醉	taozui
淫秽	yinhui
遥感	yaogan
归根	guigen
直觉	zhijue
奔跑	benpao
茶杯	chabei
流派	liupai
带队	daidui
十佳	shijia
递增	dizeng
休假	xiujia
嘿嘿	heihei
奋进	fenjin
沼气	zhaoqi
奔驰	benchi
高楼	gaolou
国门	guomen
搜寻	souxun
地名	diming
搞活	gaohuo
废止	feizhi
勾结	goujie
乐园	leyuan
让步	rangbu
体能	tineng
万分	wanfen
大王	dawang
队友	duiyou
别看	biekan
投保	toubao
惭愧	cankui
到会	daohui
总计	zongji
求助	qiuzhu
堡垒	baolei
宽大	kuanda
印制	yinzhi
故宫	gugong
后劲	houjin
再造	zaizao
轮胎	luntai
胡说	hushuo
花草	huacao
分外	fenwai
沮丧	jusang
少于	shaoyu
既定	jiding
平息	pingxi
诸位	zhuwei
定律	dinglv
家家	jiajia
手册	shouce
奔走	benzou
坦然	tanran
名气	mingqi
扣除	kouchu
电阻	dianzu
救国	jiuguo
践踏	jianta
启用	qiyong
药材	yaocai
分数	fenshu
湿润	shirun
谋划	mouhua
殖民	zhimin
函数	hanshu
雕刻	diaoke
发烧	fashao
立功	ligong
偏僻	pianpi
失学	shixue
萌芽	mengya
嘉宾	jiabin
空袭	kongxi
罗盘	luopan
大年	danian
摊派	tanpai
斗志	douzhi
开赛	kaisai
万岁	wansui
好心	haoxin
推介	tuijie
幸而	xinger
浮动	fudong
派别	paibie
淡化	danhua
凳子	dengzi
发愁	fachou
善意	shanyi
书刊	shukan
查阅	chayue
变异	bianyi
甜蜜	tianmi
废旧	feijiu
瓶子	pingzi
错过	cuoguo
供热	gongre
银牌	yinpai
鞠躬	jugong
图形	tuxing
大关	daguan
回信	huixin
尺寸	chicun
好友	haoyou
愚蠢	yuchun
没错	meicuo
探亲	tanqin
严寒	yanhan
埋头	maitou
噪音	zaoyin
海滩	haitan
凝固	ninggu
分头	fentou
农历	nongli
学派	xuepai
脉络	mailuo
摇篮	yaolan
服用	fuyong
包裹	baoguo
词典	cidian
急性	jixing
来宾	laibin
条子	tiaozi
学界	xuejie
首府	shoufu
部件	bujian
定居	dingju
贩卖	fanmai
学士	xueshi
短波	duanbo
公德	gongde
解剖	jiepou
篇幅	pianfu
过节	guojie
别扭	bieniu
高价	gaojia
愤慨	fenkai
开头	kaitou
驾车	jiache
求职	qiuzhi
地层	diceng
造假	zaojia
扭头	niutou
陪伴	peiban
护照	huzhao
油菜	youcai
弹药	danyao
后世	houshi
美感	meigan
奶粉	naifen
琢磨	zhuomo
西边	xibian
小儿	xiaoer
负债	fuzhai
产地	chandi
尘土	chentu
畜禽	chuqin
抚养	fuyang
饮酒	yinjiu
坦白	tanbai
支流	zhiliu
老爹	laodie
糟糕	zaogao
报废	baofei
俨然	yanran
话音	huayin
手帕	shoupa
疗法	liaofa
人造	renzao
东欧	dongou
步兵	bubing
无权	wuquan
倒退	daotui
机票	jipiao
哪能	naneng
移送	yisong
察觉	chajue
帝王	diwang
紧缩	jinsuo
身躯	shenqu
车轮	chelun
举手	jushou
外围	waiwei
扫除	saochu
拟定	niding
炮弹	paodan
沉积	chenji
车门	chemen
面色	mianse
谦虚	qianxu
残忍	canren
村落	cunluo
苗木	miaomu
法令	faling
男单	nandan
疯子	fengzi
开国	kaiguo
家禽	jiaqin
驻外	zhuwai
归结	guijie
欣然	xinran
语调	yudiao
好汉	haohan
罢工	bagong
不公	bugong
老者	laozhe
威严	weiyan
原野	yuanye
昂贵	anggui
哽咽	gengye
勘察	kancha
求学	qiuxue
白人	bairen
加倍	jiabei
反问	fanwen
海岛	haidao
蕴含	yunhan
濒临	binlin
加油	jiayou
书信	shuxin
下台	xiatai
庸俗	yongsu
共和	gonghe
团聚	tuanju
波浪	bolang
出血	chuxie
归属	guishu
紧缺	jinque
涉外	shewai
激战	jizhan
质问	zhiwen
非但	feidan
月刊	yuekan
激荡	jidang
回扣	huikou
要害	yaohai
早餐	zaocan
汉人	hanren
路灯	ludeng
求实	qiushi
事态	shitai
收割	shouge
工期	gongqi
咱俩	zanlia
掠夺	lveduo
失信	shixin
关押	guanya
除外	chuwai
无缘	wuyuan
地税	dishui
难处	nanchu
片子	pianzi
同比	tongbi
浮现	fuxian
感触	ganchu
后台	houtai
空地	kongdi
丝绸	sichou
边区	bianqu
不等	budeng
类别	leibie
耗费	haofei
票子	piaozi
夜空	yekong
质询	zhixun
劳累	laolei
忙于	mangyu
炮火	paohuo
贪婪	tanlan
浏览	liulan
遍地	biandi
骚扰	saorao
紧跟	jingen
千古	qiangu
口音	kouyin
路径	lujing
受苦	shouku
走势	zoushi
背叛	beipan
新药	xinyao
付款	fukuan
胡乱	huluan
编剧	bianju
再有	zaiyou
迎合	yinghe
烦躁	fanzao
鼻孔	bikong
巨变	jubian
出嫁	chujia
观摩	guanmo
进修	jinxiu
勉励	mianli
王府	wangfu
炸药	zhayao
存储	cunchu
车祸	chehuo
舞厅	wuting
选取	xuanqu
钉子	dingzi
老化	laohua
无名	wuming
赤道	chidao
宾主	binzhu
兵器	bingqi
解救	jiejiu
调和	tiaohe
无端	wuduan
呼啸	huxiao
珊瑚	shanhu
固守	gushou
弯腰	wanyao
半截	banjie
无边	wubian
因果	yinguo
觉察	juecha
分队	fendui
名目	mingmu
容器	rongqi
完好	wanhao
公诉	gongsu
域名	yuming
案情	anqing
捐资	juanzi
不善	bushan
好感	haogan
换取	huanqu
就近	jiujin
流感	liugan
女郎	nvlang
绘制	huizhi
脑筋	naojin
突变	tubian
王子	wangzi
为数	weishu
搜查	soucha
泄露	xielou
白菜	baicai
卡通	katong
归国	guiguo
雇员	guyuan
庆贺	qinghe
精辟	jingpi
乳房	rufang
感知	ganzhi
留言	liuyan
入睡	rushui
授课	shouke
叶片	yepian
树干	shugan
失落	shiluo
开垦	kaiken
出海	chuhai
野兽	yeshou
票据	piaoju
全集	quanji
月初	yuechu
技工	jigong
灭绝	miejue
女兵	nvbing
外在	waizai
迟早	chizao
傻瓜	shagua
加班	jiaban
分会	fenhui
青蛙	qingwa
钓鱼	diaoyu
敏捷	minjie
泪珠	leizhu
干流	ganliu
贵宾	guibin
修好	xiuhao
住所	zhusuo
婚事	hunshi
外头	waitou
定理	dingli
领悟	lingwu
启蒙	qimeng
新婚	xinhun
代为	daiwei
管护	guanhu
扭亏	niukui
形体	xingti
盘活	panhuo
劝阻	quanzu
拦截	lanjie
奇妙	qimiao
山野	shanye
才干	caigan
代谢	daixie
多多	duoduo
参看	cankan
胆怯	danqie
假话	jiahua
凸显	tuxian
沙丘	shaqiu
撤职	chezhi
用法	yongfa
国宝	guobao
自筹	zichou
包揽	baolan
绝非	juefei
闻讯	wenxun
估算	gusuan
好歹	haodai
间隔	jiange
解困	jiekun
男篮	nanlan
恳求	kenqiu
铁人	tieren
楼道	loudao
倾诉	qingsu
下文	xiawen
摊位	tanwei
透视	toushi
肝炎	ganyan
逃脱	taotuo
新作	xinzuo
新书	xinshu
对流	duiliu
组团	zutuan
荣立	rongli
标记	biaoji
副官	fuguan
教徒	jiaotu
殷切	yinqie
派驻	paizhu
涂料	tuliao
废话	feihua
铅笔	qianbi
查验	chayan
黑板	heiban
白纸	baizhi
头号	touhao
护送	husong
聘任	pinren
税法	shuifa
绚丽	xuanli
非得	feidei
杰作	jiezuo
截流	jieliu
摧残	cuican
引诱	yinyou
差错	chacuo
剧情	juqing
胃口	weikou
棉袄	mianao
要位	yaowei
裁军	caijun
横幅	hengfu
蜜蜂	mifeng
围困	weikun
协办	xieban
撤退	chetui
殷勤	yinqin
劳改	laogai
后头	houtou
衬衣	chenyi
停业	tingye
明晰	mingxi
化验	huayan
送达	songda
触犯	chufan
随口	suikou
蜿蜒	wanyan
罪过	zuiguo
近邻	jinlin
稻草	daocao
电磁	dianci
繁衍	fanyan
活人	huoren
主演	zhuyan
写实	xieshi
育苗	yumiao
别致	biezhi
笼子	longzi
保佑	baoyou
抨击	pengji
回味	huiwei
铸造	zhuzao
竹林	zhulin
高昂	gaoang
日产	richan
跃进	yuejin
荟萃	huicui
新秀	xinxiu
营地	yingdi
巾帼	jinguo
轮值	lunzhi
寺庙	simiao
精密	jingmi
濒危	binwei
大宗	dazong
募捐	mujuan
确信	quexin
风趣	fengqu
栏杆	langan
名利	mingli
细小	xixiao
仪表	yibiao
测控	cekong
室外	shiwai
脱落	tuoluo
客房	kefang
熏陶	xuntao
好在	haozai
集镇	jizhen
搬运	banyun
哗哗	huahua
亲信	qinxin
实干	shigan
背心	beixin
表格	biaoge
繁多	fanduo
亲临	qinlin
对峙	duizhi
柳树	liushu
苗族	miaozu
晚餐	wancan
不慎	bushen
堂屋	tangwu
讨好	taohao
得当	dedang
三北	sanbei
修筑	xiuzhu
直言	zhiyan
复仇	fuchou
闹事	naoshi
衣着	yizhuo
兵马	bingma
偏离	pianli
万国	wanguo
不当	budang
比方	bifang
标的	biaodi
妄图	wangtu
白话	baihua
赛车	saiche
铁军	tiejun
得手	deshou
无望	wuwang
选集	xuanji
主宰	zhuzai
低廉	dilian
攻读	gongdu
灭火	miehuo
疏导	shudao
选题	xuanti
贮存	zhucun
搜救	soujiu
祠堂	citang
答卷	dajuan
开眼	kaiyan
女神	nvshen
取暖	qunuan
特命	teming
挑剔	tiaoti
推诿	tuiwei
答辩	dabian
水汽	shuiqi
反差	fancha
佳作	jiazuo
进货	jinhuo
透彻	touche
调子	diaozi
嫂嫂	saosao
火花	huohua
科幻	kehuan
优劣	youlie
地缘	diyuan
出游	chuyou
呼叫	hujiao
落泪	luolei
肉类	roulei
收录	shoulu
安康	ankang
间隙	jianxi
折扣	zhekou
大名	daming
秸秆	jiegan
金秋	jinqiu
稀少	xishao
摆设	baishe
发酵	fajiao
挂职	guazhi
口味	kouwei
多亏	duokui
烈火	liehuo
千瓦	qianwa
放牧	fangmu
白酒	baijiu
后卫	houwei
苦痛	kutong
兰花	lanhua
下头	xiatou
悬崖	xuanya
主旨	zhuzhi
瓜果	guaguo
弱者	ruozhe
奢侈	shechi
退缩	tuisuo
守护	shouhu
簇拥	cuyong
焊接	hanjie
岁数	suishu
韵味	yunwei
年末	nianmo
先例	xianli
阵雨	zhenyu
调剂	tiaoji
戒备	jiebei
劳作	laozuo
养护	yanghu
腰带	yaodai
果品	guopin
醒悟	xingwu
段子	duanzi
核能	heneng
囚犯	qiufan
甘蔗	ganzhe
人品	renpin
下流	xialiu
山河	shanhe
车主	chezhu
翻阅	fanyue
铁道	tiedao
灌区	guanqu
绩效	jixiao
洗钱	xiqian
诸侯	zhuhou
害羞	haixiu
下海	xiahai
萌发	mengfa
索要	suoyao
字典	zidian
地壳	diqiao
超期	chaoqi
颠簸	dianbo
逗留	douliu
石板	shiban
原地	yuandi
陡然	douran
分担	fendan
跑道	paodao
岂能	qineng
潜伏	qianfu
来稿	laigao
电荷	dianhe
呼应	huying
略略	lvelve
伴奏	banzou
造血	zaoxue
诅咒	zuzhou
后盾	houdun
国画	guohua
悲愤	beifen
斡旋	woxuan
无能	wuneng
招募	zhaomu
会师	huishi
天赋	tianfu
名录	minglu
根治	genzhi
党旗	dangqi
官邸	guandi
少妇	shaofu
疏散	shusan
同居	tongju
着陆	zhuolu
插嘴	chazui
搀扶	chanfu
就餐	jiucan
先驱	xianqu
星系	xingxi
羞愧	xiukui
列出	liechu
违约	weiyue
病魔	bingmo
开掘	kaijue
追溯	zhuisu
伪军	weijun
棘手	jishou
滔滔	taotao
恳切	kenqie
冷酷	lengku
编码	bianma
发疯	fafeng
尘埃	chenai
即令	jiling
气功	qigong
背包	beibao
过头	guotou
巡查	xuncha
养育	yangyu
苗圃	miaopu
脱节	tuojie
大权	daquan
平地	pingdi
控诉	kongsu
诗文	shiwen
谢绝	xiejue
宝石	baoshi
寒假	hanjia
调集	diaoji
害人	hairen
随军	suijun
爹爹	diedie
回音	huiyin
澳洲	aozhou
军备	junbei
用具	yongju
存折	cunzhe
疲软	piruan
追击	zhuiji
含泪	hanlei
血脉	xuemai
缝隙	fengxi
旱灾	hanzai
华文	huawen
残害	canhai
活活	huohuo
诱导	youdao
改写	gaixie
赶走	ganzou
冬日	dongri
调皮	tiaopi
宝座	baozuo
红叶	hongye
容许	rongxu
怪物	guaiwu
劫持	jiechi
抓捕	zhuabu
作画	zuohua
不妙	bumiao
党务	dangwu
基准	jizhun
吞噬	tunshi
公厕	gongce
唠叨	laodao
如愿	ruyuan
委派	weipai
子宫	zigong
牢骚	laosao
眨眼	zhayan
纯一	chunyi
探究	tanjiu
衣衫	yishan
颠覆	dianfu
梯田	titian
罪人	zuiren
监护	jianhu
侨务	qiaowu
燃油	ranyou
珠宝	zhubao
美味	meiwei
难事	nanshi
三维	sanwei
在下	zaixia
尖子	jianzi
结尾	jiewei
据点	judian
寺院	siyuan
应诉	yingsu
浸泡	jinpao
墓葬	muzang
倍加	beijia
热能	reneng
索赔	suopei
春雨	chunyu
存有	cunyou
敬爱	jingai
农具	nongju
待人	dairen
冻土	dongtu
西风	xifeng
窟窿	kulong
台胞	taibao
逼真	bizhen
卷入	juanru
满载	manzai
点滴	diandi
欢度	huandu
消磨	xiaomo
男排	nanpai
星级	xingji
包办	baoban
废品	feipin
迷恋	milian
末了	moliao
切除	qiechu
吓人	xiaren
遮掩	zheyan
朝野	chaoye
复原	fuyuan
劲旅	jinglv
料理	liaoli
蔑视	mieshi
租用	zuyong
磁性	cixing
低沉	dichen
家畜	jiachu
旅店	lvdian
圈儿	quaner
港币	gangbi
抗体	kangti
确凿	quezao
道家	daojia
过半	guoban
境遇	jingyu
分家	fenjia
攻打	gongda
快步	kuaibu
冶炼	yelian
错位	cuowei
外加	waijia
格调	gediao
毒性	duxing
卡片	kapian
刊出	kanchu
苦练	kulian
内疚	neijiu
前去	qianqu
秧歌	yangge
苦战	kuzhan
挺拔	tingba
下载	xiazai
修饰	xiushi
坦言	tanyan
泥泞	nining
探求	tanqiu
葬礼	zangli
助残	zhucan
高位	gaowei
君主	junzhu
千米	qianmi
稿费	gaofei
海运	haiyun
好学	haoxue
猛虎	menghu
桌椅	zhuoyi
硕大	shuoda
席卷	xijuan
产区	chanqu
混蛋	hundan
女王	nvwang
入关	ruguan
液晶	yejing
版画	banhua
雇佣	guyong
蠕动	rudong
物件	wujian
霸权	baquan
对头	duitou
来人	lairen
挥霍	huihuo
英模	yingmo
婊子	biaozi
热忱	rechen
受阻	shouzu
习性	xixing
架构	jiagou
铭记	mingji
决裂	juelie
豪迈	haomai
苗子	miaozi
走狗	zougou
伪劣	weilie
存心	cunxin
汗珠	hanzhu
酒楼	jiulou
头晕	touyun
杂乱	zaluan
战马	zhanma
华诞	huadan
敲打	qiaoda
暖气	nuanqi
会徽	huihui
进士	jinshi
治学	zhixue
追捕	zhuibu
美满	meiman
石碑	shibei
初三	chusan
河段	heduan
麾下	huixia
实属	shishu
逃难	taonan
花白	huabai
咽喉	yanhou
车道	chedao
灌木	guanmu
潜入	qianru
公墓	gongmu
诙谐	huixie
氢气	qingqi
脱钩	tuogou
代办	daiban
嗜好	shihao
收据	shouju
忘我	wangwo
游玩	youwan
战俘	zhanfu
粗放	cufang
散落	sanluo
推卸	tuixie
纯朴	chunpu
盗贼	daozei
番茄	fanqie
肥皂	feizao
炮台	paotai
蹂躏	roulin
厌烦	yanfan
大款	dakuan
看透	kantou
漫游	manyou
扣留	kouliu
腰包	yaobao
嘱托	zhutuo
拨通	botong
累累	leilei
责怪	zeguai
煎熬	jianao
余年	yunian
草帽	caomao
草莓	caomei
房租	fangzu
花篮	hualan
选育	xuanyu
悔恨	huihen
紧要	jinyao
百货	baihuo
军费	junfei
死神	sishen
硬币	yingbi
战死	zhansi
放肆	fangsi
基调	jidiao
暗访	anfang
大兵	dabing
惊呼	jinghu
没完	meiwan
自首	zishou
差价	chajia
纷繁	fenfan
浅薄	qianbo
不消	buxiao
睫毛	jiemao
行医	xingyi
鞭策	biance
大典	dadian
简朴	jianpu
排演	paiyan
挽留	wanliu
训斥	xunchi
南瓜	nangua
不振	buzhen
面具	mianju
色调	sediao
一瞬	yishun
由来	youlai
翻滚	fangun
火药	huoyao
签发	qianfa
布景	bujing
知心	zhixin
狠心	henxin
冷气	lengqi
论著	lunzhu
柔道	roudao
虚幻	xuhuan
眼球	yanqiu
枣树	zaoshu
致函	zhihan
参事	canshi
丢人	diuren
告示	gaoshi
静默	jingmo
贫血	pinxue
托人	tuoren
初夏	chuxia
灰白	huibai
设若	sheruo
苏醒	suxing
探寻	tanxun
暂且	zanqie
泪花	leihua
通则	tongze
咒骂	zhouma
推倒	tuidao
倒卖	daomai
工作	gongzuo
这样	zheyang
现在	xianzai
时间	shijian
今天	jintian
思想	sixiang
同时	tongshi
北京	beijing
发生	fasheng
进行	jinxing
同志	tongzhi
领导	lingdao
政府	zhengfu
决定	jueding
应该	yinggai
出现	chuxian
之间	zhijian
学校	xuexiao
表示	biaoshi
活动	huodong
其中	qizhong
完全	wanquan
能够	nenggou
经过	jingguo
甚至	shenzhi
代表	daibiao
通过	tongguo
各种	gezhong
农民	nongmin
准备	zhunbei
全国	quanguo
了解	liaojie
力量	liliang
经验	jingyan
有关	youguan
今年	jinnian
变化	bianhua
当然	dangran
家庭	jiating
原因	yuanyin
介绍	jieshao
事情	shiqing
方式	fangshi
电话	dianhua
作用	zuoyong
多少	duoshao
农村	nongcun
现代	xiandai
运动	yundong
内容	neirong
帮助	bangzhu
人员	renyuan
建设	jianshe
怎样	zenyang
行为	xingwei
朋友	pengyou
受到	shoudao
接受	jieshou
原来	yuanlai
认真	renzhen
增加	zengjia
以上	yishang
更加	gengjia
政策	zhengce
坚持	jianchi
劳动	laodong
形式	xingshi
仍然	rengran
改变	gaibian
终于	zhongyu
实现	shixian
现实	xianshi
使用	shiyong
规定	guiding
年代	niandai
高兴	gaoxing
尽管	jinguan
总是	zongshi
工人	gongren
小时	xiaoshi
并且	bingqie
重大	zhongda
材料	cailiao
程度	chengdu
检查	jiancha
英国	yingguo
另外	lingwai
肯定	kending
反映	fanying
医生	yisheng
成立	chengli
控制	kongzhi
调查	diaocha
清楚	qingchu
集中	jizhong
实行	shixing
面对	miandui
感情	ganqing
关心	guanxin
同学	tongxue
教师	jiaoshi
产品	chanpin
胜利	shengli
眼睛	yanjing
简单	jiandan
项目	xiangmu
理想	lixiang
抓住	zhuazhu
阶段	jieduan
先进	xianjin
银行	yinhang
文明	wenming
战士	zhanshi
执行	zhixing
建筑	jianzhu
之前	zhiqian
广大	guangda
长期	changqi
大量	daliang
成绩	chengji
培养	peiyang
相互	xianghu
超过	chaoguo
著名	zhuming
稳定	wending
明白	mingbai
开展	kaizhan
电视	dianshi
职工	zhigong
明确	mingque
追求	zhuiqiu
坚决	jianjue
效果	xiaoguo
上午	shangwu
先后	xianhou
有效	youxiao
部长	buchang
适应	shiying
战略	zhanlve
掌握	zhangwo
病人	bingren
确定	queding
训练	xunlian
组成	zucheng
专业	zhuanye
网络	wangluo
前进	qianjin
交流	jiaoliu
天津	tianjin
真实	zhenshi
至少	zhishao
开放	kaifang
召开	zhaokai
主动	zhudong
解放	jiefang
看见	kanjian
从事	congshi
团结	tuanjie
姑娘	guniang
制定	zhiding
互相	huxiang
逐渐	zhujian
推动	tuidong
美元	meiyuan
危险	weixian
说话	shuohua
表演	biaoyan
公开	gongkai
采用	caiyong
运用	yunyong
委员	weiyuan
观察	guancha
马上	mashang
周围	zhouwei
商业	shangye
太阳	taiyang
本身	benshen
文件	wenjian
加快	jiakuai
整个	zhengge
南京	nanjing
拥有	yongyou
平均	pingjun
贯彻	guanche
对方	duifang
民间	minjian
消费	xiaofei
完善	wanshan
改善	gaishan
感受	ganshou
战斗	zhandou
眼前	yanqian
访问	fangwen
展开	zhankai
关注	guanzhu
冲突	chongtu
命运	mingyun
采访	caifang
小学	xiaoxue
停止	tingzhi
加工	jiagong
协调	xietiao
评价	pingjia
电脑	diannao
目光	muguang
治疗	zhiliao
显然	xianran
昨天	zuotian
心情	xinqing
面临	mianlin
总结	zongjie
百姓	baixing
寻找	xunzhao
限制	xianzhi
整体	zhengti
演员	yanyuan
究竟	jiujing
程序	chengxu
放心	fangxin
生物	shengwu
性质	xingzhi
党委	dangwei
金融	jinrong
贷款	daikuan
东北	dongbei
降低	jiangdi
动作	dongzuo
作风	zuofeng
争取	zhengqu
全球	quanqiu
当代	dangdai
标志	biaozhi
天下	tianxia
警察	jingcha
并非	bingfei
转移	zhuanyi
情感	qinggan
公民	gongmin
保险	baoxian
财产	caichan
运行	yunxing
患者	huanzhe
费用	feiyong
针对	zhendui
进展	jinzhan
相比	xiangbi
中的	zhongde
从来	conglai
即将	jijiang
四川	sichuan
作战	zuozhan
传播	chuanbo
强大	qiangda
防止	fangzhi
海洋	haiyang
非洲	feizhou
特征	tezheng
地上	dishang
北方	beifang
显著	xianzhu
黄河	huanghe
小姐	xiaojie
繁荣	fanrong
更为	gengwei
前来	qianlai
会见	huijian
后面	houmian
兴奋	xingfen
才能	caineng
立场	lichang
交给	jiaogei
准确	zhunque
春节	chunjie
带领	dailing
邀请	yaoqing
感动	gandong
牺牲	xisheng
白天	baitian
指标	zhibiao
两岸	liangan
通信	tongxin
上去	shangqu
公斤	gongjin
尽快	jinkuai
心灵	xinling
少数	shaoshu
岗位	gangwei
参观	canguan
外交	waijiao
施工	shigong
冠军	guanjun
平时	pingshi
深化	shenhua
环节	huanjie
灵魂	linghun
大众	dazhong
适当	shidang
南方	nanfang
检验	jianyan
流动	liudong
身份	shenfen
职能	zhineng
概念	gainian
教学	jiaoxue
种子	zhongzi
进攻	jingong
现有	xianyou
外面	waimian
判断	panduan
下面	xiamian
温暖	wennuan
队员	duiyuan
微笑	weixiao
迎接	yingjie
县委	xianwei
推行	tuixing
新型	xinxing
教训	jiaoxun
等待	dengdai
上级	shangji
收费	shoufei
简直	jianzhi
消除	xiaochu
经费	jingfei
共有	gongyou
气象	qixiang
卫星	weixing
有限	youxian
评论	pinglun
带动	daidong
对手	duishou
士兵	shibing
主管	zhuguan
不良	buliang
能否	nengfou
江苏	jiangsu
国防	guofang
手术	shoushu
继承	jicheng
障碍	zhangai
红军	hongjun
当时	dangshi
前后	qianhou
异常	yichang
下岗	xiagang
学院	xueyuan
广播	guangbo
环保	huanbao
缺少	queshao
草原	caoyuan
高校	gaoxiao
刚才	gangcai
周刊	zhoukan
流行	liuxing
皇帝	huangdi
兄弟	xiongdi
证据	zhengju
建国	jianguo
补充	buchong
千万	qianwan
住房	zhufang
工会	gonghui
艰难	jiannan
达成	dacheng
机场	jichang
同胞	tongbao
重复	chongfu
流通	liutong
说道	shuodao
广西	guangxi
详细	xiangxi
海关	haiguan
当今	dangjin
条约	tiaoyue
情节	qingjie
饭店	fandian
境内	jingnei
竟然	jingran
再说	zaishuo
援助	yuanzhu
想法	xiangfa
算是	suanshi
信用	xinyong
审查	shencha
经贸	jingmao
整理	zhengli
请求	qingqiu
丈夫	zhangfu
未能	weineng
庆祝	qingzhu
收购	shougou
试点	shidian
展览	zhanlan
叫做	jiaozuo
抓紧	zhuajin
中午	zhongwu
正如	zhengru
宗旨	zongzhi
签署	qianshu
高原	gaoyuan
相继	xiangji
飞行	feixing
精心	jingxin
往来	wanglai
摄影	sheying
追究	zhuijiu
循环	xunhuan
人权	renquan
新鲜	xinxian
早晨	zaochen
权威	quanwei
审判	shenpan
棉花	mianhua
冲击	chongji
提升	tisheng
人工	rengong
民警	minjing
来源	laiyuan
江西	jiangxi
遵守	zunshou
类型	leixing
提倡	tichang
面貌	mianmao
联赛	liansai
课程	kecheng
营造	yingzao
沟通	goutong
着眼	zhuoyan
轿车	jiaoche
必将	bijiang
认定	rending
主权	zhuquan
日常	richang
专利	zhuanli
免费	mianfei
使命	shiming
较为	jiaowei
调节	tiaojie
境界	jingjie
平台	pingtai
通讯	tongxun
混乱	hunluan
电信	dianxin
原有	yuanyou
多年	duonian
随便	suibian
干净	ganjing
借鉴	jiejian
信念	xinnian
推荐	tuijian
养殖	yangzhi
奖励	jiangli
生意	shengyi
龙头	longtou
消灭	xiaomie
鲜花	xianhua
共识	gongshi
总数	zongshu
办公	bangong
比重	bizhong
宣言	xuanyan
专题	zhuanti
描写	miaoxie
国情	guoqing
当作	dangzuo
遭受	zaoshou
信仰	xinyang
更新	gengxin
观看	guankan
通道	tongdao
占有	zhanyou
原始	yuanshi
小麦	xiaomai
竞赛	jingsai
审美	shenmei
邪教	xiejiao
编制	bianzhi
浪费	langfei
生气	shengqi
教材	jiaocai
动态	dongtai
号召	haozhao
支援	zhiyuan
单纯	danchun
首脑	shounao
夏天	xiatian
调研	diaoyan
用人	yongren
收获	shouhuo
历程	licheng
球员	qiuyuan
防范	fangfan
高潮	gaochao
深处	shenchu
增进	zengjin
百年	bainian
定位	dingwei
民营	minying
灵活	linghuo
天然	tianran
常务	changwu
交谈	jiaotan
圆满	yuanman
警告	jinggao
民工	mingong
长大	changda
增多	zengduo
点头	diantou
全民	quanmin
钢铁	gangtie
当初	dangchu
失望	shiwang
力争	lizheng
领袖	lingxiu
否定	fouding
纲要	gangyao
新建	xinjian
构建	goujian
名单	mingdan
车间	chejian
阐述	chanshu
昆明	kunming
存款	cunkuan
修建	xiujian
形态	xingtai
赶快	gankuai
来访	laifang
人间	renjian
拓展	tuozhan
一向	yixiang
贵州	guizhou
故乡	guxiang
酒店	jiudian
上帝	shangdi
身后	shenhou
开通	kaitong
全军	quanjun
评为	pingwei
文献	wenxian
重组	chongzu
国王	guowang
宁夏	ningxia
浑身	hunshen
消耗	xiaohao
变为	bianwei
相似	xiangsi
民兵	minbing
丧失	sangshi
陪同	peitong
任命	renming
组长	zuchang
燃烧	ranshao
开工	kaigong
海水	haishui
精品	jingpin
勇敢	yonggan
透明	touming
精彩	jingcai
信访	xinfang
潮流	chaoliu
连接	lianjie
知名	zhiming
升级	shengji
正义	zhengyi
排放	paifang
延伸	yanshen
游泳	youyong
投票	toupiao
年初	nianchu
坚实	jianshi
住宅	zhuzhai
释放	shifang
拖欠	tuoqian
野生	yesheng
手指	shouzhi
节能	jieneng
看望	kanwang
从未	congwei
对面	duimian
出售	chushou
军官	junguan
产值	chanzhi
嘴唇	zuichun
协定	xieding
在党	zaidang
名人	mingren
超越	chaoyue
空军	kongjun
公社	gongshe
申报	shenbao
农药	nongyao
政务	zhengwu
妥善	tuoshan
水果	shuiguo
议长	yizhang
英文	yingwen
画面	huamian
原本	yuanben
高层	gaoceng
小心	xiaoxin
运营	yunying
加深	jiashen
退耕	tuigeng
高峰	gaofeng
社员	sheyuan
泪水	leishui
厨房	chufang
收拾	shoushi
公约	gongyue
花园	huayuan
首届	shoujie
传递	chuandi
财经	caijing
测量	celiang
会员	huiyuan
情报	qingbao
生日	shengri
本领	benling
金钱	jinqian
源头	yuantou
宏伟	hongwei
水稻	shuidao
宾馆	binguan
车站	chezhan
报名	baoming
边界	bianjie
使馆	shiguan
全都	quandou
行人	xingren
中部	zhongbu
过年	guonian
整合	zhenghe
选民	xuanmin
总裁	zongcai
太原	taiyuan
分明	fenming
养老	yanglao
珍贵	zhengui
缩小	suoxiao
陌生	mosheng
动摇	dongyao
港口	gangkou
节水	jieshui
分工	fengong
应对	yingdui
华侨	huaqiao
国债	guozhai
保健	baojian
建造	jianzao
脚下	jiaoxia
境外	jingwai
渗透	shentou
青海	qinghai
跟踪	genzong
倘若	tangruo
动人	dongren
修订	xiuding
毛病	maobing
公主	gongzhu
隐患	yinhuan
实效	shixiao
城区	chengqu
远处	yuanchu
崭新	zhanxin
用来	yonglai
歌声	gesheng
书面	shumian
任用	renyong
有名	youming
强度	qiangdu
国产	guochan
电台	diantai
首要	shouyao
职权	zhiquan
黄色	huangse
燃料	ranliao
兰州	lanzhou
对抗	duikang
描述	miaoshu
家园	jiayuan
反恐	fankong
缓慢	huanman
回收	huishou
化工	huagong
名牌	mingpai
花钱	huaqian
出身	chushen
政法	zhengfa
呼声	husheng
老年	laonian
住院	zhuyuan
灌溉	guangai
验收	yanshou
税费	shuifei
拓宽	tuokuan
时空	shikong
省区	shengqu
刊登	kandeng
用品	yongpin
公告	gonggao
民航	minhang
平凡	pingfan
全新	quanxin
修养	xiuyang
收回	shouhui
平稳	pingwen
缺陷	quexian
遥远	yaoyuan
上课	shangke
东南	dongnan
筹备	choubei
未经	weijing
古城	gucheng
总队	zongdui
困境	kunjing
镜头	jingtou
走访	zoufang
领会	linghui
撤销	chexiao
超市	chaoshi
为首	weishou
管道	guandao
难免	nanmian
等候	denghou
联络	lianluo
聘请	pinqing
扩展	kuozhan
平民	pingmin
展出	zhanchu
停留	tingliu
排名	paiming
三农	sannong
吃惊	chijing
反动	fandong
传达	chuanda
会同	huitong
多边	duobian
每当	meidang
狠抓	henzhua
笑话	xiaohua
沙龙	shalong
场地	changdi
行列	hanglie
战术	zhanshu
救援	jiuyuan
农家	nongjia
水质	shuizhi
何况	hekuang
缩短	suoduan
难点	nandian
阶层	jieceng
人身	renshen
同类	tonglei
政绩	zhengji
虽说	suishuo
影视	yingshi
乘客	chengke
短缺	duanque
太空	taikong
放开	fangkai
荣获	ronghuo
空白	kongbai
投产	touchan
多样	duoyang
约定	yueding
苹果	pingguo
心脏	xinzang
游行	youxing
缺点	quedian
描绘	miaohui
表决	biaojue
反抗	fankang
线索	xiansuo
侦查	zhencha
抓获	zhuahuo
从严	congyan
交叉	jiaocha
秋天	qiutian
间接	jianjie
人性	renxing
傍晚	bangwan
前者	qianzhe
中期	zhongqi
念头	niantou
怎能	zenneng
抽查	choucha
接连	jielian
看病	kanbing
未免	weimian
原告	yuangao
被动	beidong
食堂	shitang
年均	nianjun
硕士	shuoshi
赞扬	zanyang
前列	qianlie
前沿	qianyan
火箭	huojian
连队	liandui
书店	shudian
申办	shenban
转达	zhuanda
账户	zhanghu
学说	xueshuo
弟兄	dixiong
拼命	pinming
惊人	jingren
中医	zhongyi
无偿	wuchang
深切	shenqie
对照	duizhao
竣工	jungong
风貌	fengmao
途中	tuzhong
油田	youtian
谁知	sheizhi
报酬	baochou
走廊	zoulang
跟前	genqian
浪漫	langman
首位	shouwei
和尚	heshang
楼房	loufang
人选	renxuan
新春	xinchun
生死	shengsi
投身	toushen
睡着	shuizhe
场合	changhe
当下	dangxia
倡议	changyi
年会	nianhui
受灾	shouzai
外边	waibian
风采	fengcai
盼望	panwang
主编	zhubian
招聘	zhaopin
关切	guanqie
春秋	chunqiu
显出	xianchu
倾斜	qingxie
浓厚	nonghou
角落	jiaoluo
整齐	zhengqi
大娘	daniang
逐年	zhunian
来往	laiwang
印刷	yinshua
潜在	qianzai
中级	zhongji
战后	zhanhou
蓝天	lantian
南宁	nanning
邮票	youpiao
仍旧	rengjiu
颜色	yanshai
休闲	xiuxian
纯粹	chuncui
惩罚	chengfa
生涯	shengya
强迫	qiangpo
合成	hecheng
维权	weiquan
凭借	pingjie
认同	rentong
果断	guoduan
忍受	renshou
尖锐	jianrui
编写	bianxie
暂行	zanxing
难忘	nanwang
难受	nanshou
绝望	juewang
话说	huashuo
涉嫌	shexian
好评	haoping
尊敬	zunjing
订单	dingdan
丛书	congshu
阴影	yinying
园林	yuanlin
赞同	zantong
打仗	dazhang
遗传	yichuan
应邀	yingyao
超出	chaochu
派遣	paiqian
永久	yongjiu
竟是	jingshi
汗水	hanshui
滥用	lanyong
净化	jinghua
再现	zaixian
下令	xialing
太平	taiping
造型	zaoxing
两侧	liangce
现任	xianren
拆除	chaichu
箱子	xiangzi
分行	fenxing
抗旱	kanghan
自称	zicheng
侵权	qinquan
身材	shencai
宣告	xuangao
界限	jiexian
根源	genyuan
演变	yanbian
范畴	fanchou
振奋	zhenfen
封锁	fengsuo
火星	huoxing
播种	bozhong
歌唱	gechang
房门	fangmen
电报	dianbao
黄土	huangtu
高等	gaodeng
人情	renqing
彩电	caidian
团伙	tuanhuo
唱歌	changge
无声	wusheng
谨慎	jinshen
搬迁	banqian
供求	gongqiu
贵阳	guiyang
出动	chudong
三角	sanjiao
索性	suoxing
暗中	anzhong
满堂	mantang
未曾	weiceng
艰辛	jianxin
头顶	touding
电池	dianchi
每逢	meifeng
抱怨	baoyuan
天文	tianwen
公报	gongbao
罕见	hanjian
激光	jiguang
男性	nanxing
携手	xieshou
结算	jiesuan
高山	gaoshan
颤抖	chandou
迅猛	xunmeng
年内	niannei
上诉	shangsu
墙壁	qiangbi
受过	shouguo
往事	wangshi
交代	jiaodai
元旦	yuandan
价钱	jiaqian
处境	chujing
航班	hangban
家电	jiadian
峰会	fenghui
只管	zhiguan
兑现	duixian
全会	quanhui
生育	shengyu
点燃	dianran
踊跃	yongyue
管制	guanzhi
心愿	xinyuan
优点	youdian
中毒	zhongdu
有望	youwang
水位	shuiwei
后边	houbian
知青	zhiqing
党报	dangbao
电流	dianliu
方才	fangcai
垂直	chuizhi
漏洞	loudong
天才	tiancai
站住	zhanzhu
诞辰	danchen
简化	jianhua
水分	shuifen
钢琴	gangqin
保守	baoshou
夺冠	duoguan
通车	tongche
翅膀	chibang
道歉	daoqian
罪行	zuixing
辩论	bianlun
苍白	cangbai
物种	wuzhong
凭着	pingzhe
少有	shaoyou
癌症	aizheng
餐厅	canting
当晚	dangwan
在校	zaixiao
方略	fanglve
快活	kuaihuo
客商	keshang
多方	duofang
就算	jiusuan
饮料	yinliao
挪用	nuoyong
寒冷	hanleng
短暂	duanzan
门票	menpiao
轰炸	hongzha
三通	santong
征地	zhengdi
风暴	fengbao
行走	xingzou
直线	zhixian
本能	benneng
真心	zhenxin
增值	zengzhi
出面	chumian
教会	jiaohui
女生	nvsheng
传奇	chuanqi
经纬	jingwei
再见	zaijian
难怪	nanguai
请问	qingwen
签约	qianyue
拳头	quantou
冰雪	bingxue
团队	tuandui
网球	wangqiu
连锁	liansuo
最快	zuikuai
图像	tuxiang
简报	jianbao
治病	zhibing
山村	shancun
幸运	xingyun
衔接	xianjie
编者	bianzhe
社团	shetuan
输送	shusong
徘徊	paihuai
奋战	fenzhan
珍珠	zhenzhu
招待	zhaodai
诚意	chengyi
清新	qingxin
名列	minglie
审视	shenshi
管辖	guanxia
精美	jingmei
芯片	xinpian
借款	jiekuan
参展	canzhan
民用	minyong
手下	shouxia
书房	shufang
主线	zhuxian
扩建	kuojian
两地	liangdi
削减	xuejian
剧场	juchang
故障	guzhang
性别	xingbie
拥抱	yongbao
特种	tezhong
出院	chuyuan
献给	xiangei
邮件	youjian
高档	gaodang
鲜血	xianxue
猛然	mengran
取向	quxiang
高产	gaochan
民情	minqing
称呼	chenghu
乡里	xiangli
悬挂	xuangua
投放	toufang
亲身	qinshen
扰乱	raoluan
军营	junying
精确	jingque
建材	jiancai
停火	tinghuo
小品	xiaopin
备战	beizhan
对应	duiying
表态	biaotai
追赶	zhuigan
春运	chunyun
车型	chexing
沿线	yanxian
销毁	xiaohui
内战	neizhan
商议	shangyi
多元	duoyuan
属性	shuxing
彩票	caipiao
无穷	wuqiong
均衡	junheng
震撼	zhenhan
国营	guoying
周到	zhoudao
棺材	guancai
王国	wangguo
议程	yicheng
购销	gouxiao
门诊	menzhen
台风	taifeng
分管	fenguan
做梦	zuomeng
揭晓	jiexiao
军方	junfang
牵头	qiantou
取胜	qusheng
流水	liushui
料到	liaodao
往后	wanghou
美洲	meizhou
鸟类	niaolei
用心	yongxin
胸脯	xiongpu
长度	changdu
视角	shijiao
新颖	xinying
身心	shenxin
海啸	haixiao
捐助	juanzhu
嘴角	zuijiao
交涉	jiaoshe
冒险	maoxian
喉咙	houlong
东海	donghai
论断	lunduan
结晶	jiejing
卓越	zhuoyue
引用	yinyong
推销	tuixiao
面包	mianbao
亲情	qinqing
猛烈	menglie
绑架	bangjia
熟练	shulian
抽烟	chouyan
指望	zhiwang
表述	biaoshu
失踪	shizong
署名	shuming
北风	beifeng
风沙	fengsha
情人	qingren
隐藏	yincang
海面	haimian
不光	buguang
玩笑	wanxiao
迹象	jixiang
兴办	xingban
渔船	yuchuan
典范	dianfan
全文	quanwen
宽阔	kuankuo
自强	ziqiang
流氓	liumang
白宫	baigong
长足	changzu
直径	zhijing
绳子	shengzi
巡警	xunjing
上马	shangma
导航	daohang
多层	duoceng
回应	huiying
党派	dangpai
折腾	zheteng
暂停	zanting
陈旧	chenjiu
种族	zhongzu
情操	qingcao
药店	yaodian
高手	gaoshou
便民	bianmin
运送	yunsong
亲手	qinshou
富强	fuqiang
查明	chaming
注定	zhuding
悲痛	beitong
高明	gaoming
热量	reliang
备受	beishou
军用	junyong
分手	fenshou
用药	yongyao
肥料	feiliao
宣誓	xuanshi
怀抱	huaibao
神社	shenshe
弹性	tanxing
美妙	meimiao
埋怨	manyuan
神态	shentai
名家	mingjia
样品	yangpin
滋生	zisheng
枕头	zhentou
翻身	fanshen
助手	zhushou
总得	zongdei
出差	chuchai
容忍	rongren
弱点	ruodian
操纵	caozong
追问	zhuiwen
童话	tonghua
转入	zhuanru
明知	mingzhi
晚年	wannian
恰当	qiadang
言行	yanxing
心疼	xinteng
公然	gongran
路上	lushang
防汛	fangxun
象棋	xiangqi
等到	dengdao
减弱	jianruo
文凭	wenping
协同	xietong
相遇	xiangyu
裁定	caiding
订阅	dingyue
出让	churang
投标	toubiao
钻研	zuanyan
背影	beiying
促成	cucheng
好听	haoting
下边	xiabian
报销	baoxiao
但愿	danyuan
随手	suishou
发光	faguang
好坏	haohuai
界定	jieding
江河	jianghe
赶忙	ganmang
红火	honghuo
茫然	mangran
完工	wangong
攀登	pandeng
体重	tizhong
开水	kaishui
信封	xinfeng
专机	zhuanji
快捷	kuaijie
前人	qianren
草坪	caoping
鲜艳	xianyan
定价	dingjia
狭窄	xiazhai
稍微	shaowei
并存	bingcun
兵士	bingshi
选派	xuanpai
报警	baojing
教导	jiaodao
诈骗	zhapian
没用	meiyong
青睐	qinglai
满怀	manhuai
微观	weiguan
筹措	choucuo
防火	fanghuo
方言	fangyan
填写	tianxie
老兵	laobing
山头	shantou
下山	xiashan
参照	canzhao
恍惚	huanghu
任免	renmian
改建	gaijian
领略	linglve
同伴	tongban
话筒	huatong
精致	jingzhi
风云	fengyun
保全	baoquan
日程	richeng
学风	xuefeng
念书	nianshu
检讨	jiantao
招牌	zhaopai
简陋	jianlou
标本	biaoben
劳工	laogong
指点	zhidian
旁人	pangren
票价	piaojia
丰厚	fenghou
沉浸	chenjin
乐团	yuetuan
柔软	rouruan
反省	fanxing
寒风	hanfeng
泰山	taishan
早点	zaodian
鲜活	xianhuo
下水	xiashui
演说	yanshuo
繁忙	fanmang
指令	zhiling
禁令	jinling
阳台	yangtai
在手	zaishou
餐桌	canzhuo
售价	shoujia
仇恨	chouhen
史料	shiliao
大奖	dajiang
陈述	chenshu
便道	biandao
讲课	jiangke
停车	tingche
腾飞	tengfei
坏事	huaishi
教书	jiaoshu
轻视	qingshi
网友	wangyou
停顿	tingdun
单调	dandiao
流浪	liulang
亲王	qinwang
巴掌	bazhang
名著	mingzhu
保管	baoguan
下放	xiafang
航运	hangyun
担当	dandang
加盟	jiameng
录像	luxiang
中西	zhongxi
陈列	chenlie
对称	duichen
盛大	shengda
叮嘱	dingzhu
灵感	linggan
置身	zhishen
出钱	chuqian
损坏	sunhuai
身高	shengao
皱纹	zhouwen
版权	banquan
阴阳	yinyang
呻吟	shenyin
洋人	yangren
凄凉	qiliang
生怕	shengpa
特长	techang
灯火	denghuo
慷慨	kangkai
左边	zuobian
侨胞	qiaobao
后方	houfang
忧患	youhuan
早年	zaonian
悄然	qiaoran
查找	chazhao
指控	zhikong
果园	guoyuan
心跳	xintiao
决战	juezhan
配送	peisong
冷淡	lengdan
凝视	ningshi
外援	waiyuan
追逐	zhuizhu
矿业	kuangye
中巴	zhongba
月饼	yuebing
废水	feishui
氧化	yanghua
学堂	xuetang
真切	zhenqie
纠缠	jiuchan
茶馆	chaguan
冻结	dongjie
花样	huayang
难关	nanguan
相距	xiangju
周岁	zhousui
交织	jiaozhi
罪名	zuiming
头痛	toutong
往返	wangfan
检索	jiansuo
出行	chuxing
纸条	zhitiao
沸腾	feiteng
火山	huoshan
外表	waibiao
饭馆	fanguan
滚动	gundong
崩溃	bengkui
骤然	zhouran
老总	laozong
手持	shouchi
出兵	chubing
软弱	ruanruo
祥和	xianghe
尽情	jinqing
退还	tuihuan
兼任	jianren
归还	guihuan
好笑	haoxiao
铲除	chanchu
胜负	shengfu
扫描	saomiao
心境	xinjing
到手	daoshou
关头	guantou
舰队	jiandui
打响	daxiang
海边	haibian
侵占	qinzhan
老龄	laoling
踌躇	chouchu
村镇	cunzhen
走动	zoudong
坏人	huairen
新兵	xinbing
样式	yangshi
围攻	weigong
用处	yongchu
华东	huadong
缩影	suoying
确诊	quezhen
制售	zhishou
后天	houtian
蕴藏	yuncang
惊叹	jingtan
行军	xingjun
幸亏	xingkui
警报	jingbao
高龄	gaoling
设定	sheding
大专	dazhuan
借用	jieyong
超载	chaozai
全然	quanran
温泉	wenquan
客场	kechang
环球	huanqiu
飞快	feikuai
要命	yaoming
长途	changtu
关节	guanjie
喊叫	hanjiao
右边	youbian
天黑	tianhei
关门	guanmen
干线	ganxian
眼角	yanjiao
施展	shizhan
稿件	gaojian
轻微	qingwei
火柴	huochai
肩头	jiantou
且说	qieshuo
血管	xueguan
拥军	yongjun
珠峰	zhufeng
钱财	qiancai
磁场	cichang
沉吟	chenyin
下手	xiashou
育种	yuzhong
瘫痪	tanhuan
患有	huanyou
忘却	wangque
窑洞	yaodong
山林	shanlin
稻田	daotian
清查	qingcha
着实	zhuoshi
拜访	baifang
风流	fengliu
议政	yizheng
灭亡	miewang
网民	wangmin
悲观	beiguan
上路	shanglu
麻将	majiang
实说	shishuo
淡水	danshui
流淌	liutang
现存	xiancun
懂事	dongshi
条文	tiaowen
养活	yanghuo
公道	gongdao
百官	baiguan
改观	gaiguan
真挚	zhenzhi
溶解	rongjie
雪山	xueshan
鞭炮	bianpao
能耗	nenghao
灰尘	huichen
丢掉	diudiao
看守	kanshou
开端	kaiduan
面粉	mianfen
战国	zhanguo
减灾	jianzai
增设	zengshe
称职	chenzhi
孔雀	kongque
娘子	niangzi
随身	suishen
灾情	zaiqing
中叶	zhongye
党刊	dangkan
茶房	chafang
水流	shuiliu
车票	chepiao
演练	yanlian
做官	zuoguan
匈奴	xiongnu
从头	congtou
友情	youqing
江湖	jianghu
收缩	shousuo
放学	fangxue
计量	jiliang
路程	lucheng
怀孕	huaiyun
受损	shousun
种地	zhongdi
抒情	shuqing
危房	weifang
脂肪	zhifang
财税	caishui
侧重	cezhong
有功	yougong
本性	benxing
矿区	kuangqu
开庭	kaiting
慢性	manxing
圣地	shengdi
出名	chuming
辽阔	liaokuo
交接	jiaojie
听话	tinghua
中途	zhongtu
型号	xinghao
照耀	zhaoyao
飞扬	feiyang
缴费	jiaofei
摘要	zhaiyao
美容	meirong
举重	juzhong
外观	waiguan
对联	duilian
热衷	rezhong
纵然	zongran
改名	gaiming
国税	guoshui
诠释	quanshi
单边	danbian
切断	qieduan
考评	kaoping
廉价	lianjia
照着	zhaozhe
缴获	jiaohuo
对准	duizhun
炮兵	paobing
板凳	bandeng
长子	zhangzi
杠杆	ganggan
何尝	hechang
平坦	pingtan
冷却	lengque
耕作	gengzuo
管家	guanjia
画展	huazhan
高空	gaokong
精髓	jingsui
开关	kaiguan
后院	houyuan
动画	donghua
威风	weifeng
前辈	qianbei
含笑	hanxiao
探望	tanwang
偏差	piancha
行车	xingche
责成	zecheng
肮脏	angzang
清单	qingdan
山沟	shangou
牧场	muchang
外债	waizhai
柴油	chaiyou
老远	laoyuan
板块	bankuai
铜牌	tongpai
红包	hongbao
时段	shiduan
果真	guozhen
功勋	gongxun
照射	zhaoshe
丑闻	chouwen
火烧	huoshao
昂扬	angyang
通告	tonggao
败坏	baihuai
怜悯	lianmin
营运	yingyun
凝结	ningjie
远近	yuanjin
任教	renjiao
吵架	chaojia
聘用	pinyong
连任	lianren
头疼	touteng
终日	zhongri
别说	bieshuo
名言	mingyan
丰满	fengman
高官	gaoguan
毁坏	huihuai
降雨	jiangyu
航道	hangdao
快车	kuaiche
受害	shouhai
留守	liushou
诊所	zhensuo
调配	tiaopei
筹划	chouhua
辍学	chuoxue
微妙	weimiao
出战	chuzhan
样本	yangben
手腕	shouwan
遵照	zunzhao
清脆	qingcui
半天	bantian
登台	dengtai
明月	mingyue
访谈	fangtan
冷落	lengluo
小车	xiaoche
探险	tanxian
放射	fangshe
觉醒	juexing
盲人	mangren
召回	zhaohui
归侨	guiqiao
失衡	shiheng
守信	shouxin
行进	xingjin
清澈	qingche
会面	huimian
放假	fangjia
环绕	huanrao
妥当	tuodang
炒作	chaozuo
下调	xiatiao
桂冠	guiguan
功劳	gonglao
留念	liunian
丰碑	fengbei
配件	peijian
校舍	xiaoshe
放慢	fangman
善后	shanhou
准是	zhunshi
共存	gongcun
阐释	chanshi
焚烧	fenshao
行贿	xinghui
分辨	fenbian
审讯	shenxun
写照	xiezhao
禀报	bingbao
喘息	chuanxi
排练	pailian
融洽	rongqia
文盲	wenmang
洪涝	honglao
围剿	weijiao
辨别	bianbie
专科	zhuanke
完了	wanliao
公家	gongjia
农垦	nongken
树苗	shumiao
环卫	huanwei
敬佩	jingpei
领队	lingdui
营救	yingjiu
先导	xiandao
院落	yuanluo
鉴别	jianbie
事前	shiqian
天使	tianshi
支票	zhipiao
莲花	lianhua
评判	pingpan
切身	qieshen
执著	zhizhuo
盘算	pansuan
时评	shiping
有病	youbing
选购	xuangou
书桌	shuzhuo
店主	dianzhu
断绝	duanjue
叫喊	jiaohan
新郎	xinlang
家用	jiayong
随行	suixing
电车	dianche
彩虹	caihong
松树	songshu
风雪	fengxue
事变	shibian
但见	danjian
挑衅	tiaoxin
漂流	piaoliu
严防	yanfang
抱歉	baoqian
启程	qicheng
钻石	zuanshi
齐声	qisheng
就诊	jiuzhen
池塘	chitang
免除	mianchu
兑换	duihuan
黑影	heiying
耕耘	gengyun
排水	paishui
引水	yinshui
狡猾	jiaohua
亮丽	liangli
动感	donggan
指针	zhizhen
军校	junxiao
玩耍	wanshua
宣判	xuanpan
勇士	yongshi
广义	guangyi
渲染	xuanran
版面	banmian
军舰	junjian
校门	xiaomen
坐标	zuobiao
短信	duanxin
报送	baosong
查封	chafeng
简要	jianyao
头等	toudeng
展品	zhanpin
编号	bianhao
厉声	lisheng
广度	guangdu
日光	riguang
浓缩	nongsuo
沉闷	chenmen
关口	guankou
盘旋	panxuan
深邃	shensui
检阅	jianyue
方位	fangwei
发亮	faliang
满身	manshen
转播	zhuanbo
扁担	biandan
免职	mianzhi
电缆	dianlan
荒漠	huangmo
偶像	ouxiang
市容	shirong
救命	jiuming
憔悴	qiaocui
判定	panding
深造	shenzao
晚间	wanjian
烟囱	yancong
编造	bianzao
奋勇	fenyong
请假	qingjia
辨认	bianren
军警	junjing
款待	kuandai
清白	qingbai
融化	ronghua
战火	zhanhuo
花圈	huaquan
棉被	mianbei
老少	laoshao
俗称	sucheng
留恋	liulian
美观	meiguan
毕生	bisheng
丘陵	qiuling
山脉	shanmai
碎片	suipian
过关	guoguan
控告	konggao
松懈	songxie
公文	gongwen
奔腾	benteng
划定	huading
年份	nianfen
扫荡	saodang
存放	cunfang
口罩	kouzhao
警觉	jingjue
平淡	pingdan
抗灾	kangzai
长发	changfa
僵局	jiangju
追随	zhuisui
感应	ganying
波长	bochang
环流	huanliu
作坊	zuofang
颠倒	diandao
潜心	qianxin
主攻	zhugong
忏悔	chanhui
当家	dangjia
建构	jiangou
领带	lingdai
年画	nianhua
见闻	jianwen
硫酸	liusuan
大帅	dashuai
能干	nenggan
狂热	kuangre
怀有	huaiyou
文选	wenxuan
牵挂	qiangua
红花	honghua
推选	tuixuan
运算	yunsuan
防备	fangbei
下层	xiaceng
耳光	erguang
假定	jiading
叫好	jiaohao
空话	konghua
返还	fanhuan
刚好	ganghao
失掉	shidiao
执教	zhijiao
木匠	mujiang
塑像	suxiang
美景	meijing
文教	wenjiao
感性	ganxing
会展	huizhan
中立	zhongli
藏书	cangshu
留神	liushen
手套	shoutao
调试	tiaoshi
取证	quzheng
骗人	pianren
乡土	xiangtu
军团	juntuan
执照	zhizhao
单身	danshen
农林	nonglin
威望	weiwang
采摘	caizhai
郊外	jiaowai
随同	suitong
场次	changci
反面	fanmian
能耐	nengnai
唱戏	changxi
知晓	zhixiao
暖和	nuanhuo
部将	bujiang
分红	fenhong
樱桃	yingtao
半径	banjing
画卷	huajuan
警车	jingche
悬殊	xuanshu
些小	xiexiao
英俊	yingjun
光泽	guangze
登门	dengmen
接送	jiesong
劳教	laojiao
玩弄	wannong
顺差	shuncha
托管	tuoguan
照搬	zhaoban
夯实	hangshi
航海	hanghai
水文	shuiwen
转而	zhuaner
豪情	haoqing
拍照	paizhao
螃蟹	pangxie
牵引	qianyin
家境	jiajing
忧愁	youchou
保养	baoyang
编排	bianpai
盟国	mengguo
安详	anxiang
当心	dangxin
并购	binggou
车手	cheshou
收看	shoukan
邪说	xieshuo
筹办	chouban
挺进	tingjin
超导	chaodao
口径	koujing
增高	zenggao
死伤	sishang
小贩	xiaofan
严明	yanming
饭桌	fanzhuo
回荡	huidang
省得	shengde
偷税	toushui
浪花	langhua
冷汗	lenghan
舒展	shuzhan
温情	wenqing
捣乱	daoluan
悼念	daonian
肥胖	feipang
狭小	xiaxiao
风范	fengfan
钢筋	gangjin
外形	waixing
修缮	xiushan
秋风	qiufeng
电费	dianfei
卷烟	juanyan
千秋	qianqiu
公职	gongzhi
狼狈	langbei
头衔	touxian
群山	qunshan
硝烟	xiaoyan
表妹	biaomei
货款	huokuan
年月	nianyue
欠缺	qianque
式样	shiyang
疏通	shutong
怨恨	yuanhen
撒谎	sahuang
嗓音	sangyin
手印	shouyin
道教	daojiao
幌子	huangzi
零下	lingxia
松弛	songchi
薪水	xinshui
并列	binglie
采风	caifeng
两极	liangji
强力	qiangli
款式	kuanshi
上司	shangsi
胸部	xiongbu
闪耀	shanyao
幻觉	huanjue
沿用	yanyong
殊荣	shurong
油灯	youdeng
黑洞	heidong
沙尘	shachen
战犯	zhanfan
进兵	jinbing
明媚	mingmei
失眠	shimian
下身	xiashen
昭示	zhaoshi
面试	mianshi
有钱	youqian
转发	zhuanfa
追寻	zhuixun
吵闹	chaonao
间谍	jiandie
会诊	huizhen
劝告	quangao
管事	guanshi
点火	dianhuo
抖动	doudong
勤俭	qinjian
得逞	decheng
供货	gonghuo
流亡	liuwang
甜头	tiantou
闲谈	xiantan
厌倦	yanjuan
药房	yaofang
断裂	duanlie
建树	jianshu
本钱	benqian
差事	chaishi
丑陋	choulou
绵延	mianyan
做工	zuogong
总揽	zonglan
会馆	huiguan
开行	kaixing
灵敏	lingmin
轻蔑	qingmie
导线	daoxian
报表	baobiao
菜园	caiyuan
相爱	xiangai
找寻	zhaoxun
厂子	changzi
检修	jianxiu
动辄	dongzhe
断然	duanran
多情	duoqing
添加	tianjia
对阵	duizhen
过快	guokuai
露面	loumian
埋葬	maizang
名优	mingyou
光顾	guanggu
税金	shuijin
信教	xinjiao
班禅	banchan
剪刀	jiandao
相符	xiangfu
越冬	yuedong
侦探	zhentan
收买	shoumai
痛恨	tonghen
公办	gongban
恭维	gongwei
来电	laidian
精干	jinggan
假说	jiashuo
批量	piliang
直航	zhihang
汇款	huikuan
任凭	renping
下沉	xiachen
外方	waifang
珍品	zhenpin
防灾	fangzai
汇总	huizong
手头	shoutou
着落	zhuoluo
射箭	shejian
书院	shuyuan
矿物	kuangwu
年货	nianhuo
眼圈	yanquan
失调	shitiao
杂种	zazhong
光谱	guangpu
摆动	baidong
享乐	xiangle
一晃	yihuang
订货	dinghuo
审结	shenjie
锁定	suoding
候选	houxuan
门面	menmian
养分	yangfen
幼年	younian
洞口	dongkou
芬芳	fenfang
获准	huozhun
治水	zhishui
更改	genggai
原文	yuanwen
顶多	dingduo
槐树	huaishu
样板	yangban
绰号	chuohao
改用	gaiyong
捆绑	kunbang
半空	bankong
红薯	hongshu
门房	menfang
杀手	shashou
过境	guojing
彗星	huixing
南边	nanbian
领事	lingshi
炫耀	xuanyao
好受	haoshou
守候	shouhou
喧闹	xuannao
观音	guanyin
减肥	jianfei
喂养	weiyang
阴沉	yinchen
英寸	yingcun
时辰	shichen
仓储	cangchu
吃水	chishui
出产	chuchan
号令	haoling
交错	jiaocuo
混淆	hunxiao
内行	neihang
单产	danchan
球星	qiuxing
束手	shushou
置换	zhihuan
表姐	biaojie
手背	shoubei
金边	jinbian
照旧	zhaojiu
回访	huifang
怨言	yuanyan
震慑	zhenshe
险些	xianxie
茶水	chashui
朝代	chaodai
凑巧	couqiao
前卫	qianwei
天数	tianshu
快感	kuaigan
相隔	xiangge
眼见	yanjian
悠扬	youyang
苍老	canglao
恰巧	qiaqiao
断言	duanyan
针灸	zhenjiu
风味	fengwei
家教	jiajiao
步枪	buqiang
驰名	chiming
全盘	quanpan
细长	xichang
小吃	xiaochi
成语	chengyu
到访	daofang
菜农	cainong
灯泡	dengpao
开朗	kailang
包容	baorong
当月	dangyue
三更	sangeng
硕果	shuoguo
政客	zhengke
牵涉	qianshe
述评	shuping
真假	zhenjia
不胜	busheng
出山	chushan
宠物	chongwu
点球	dianqiu
公决	gongjue
适龄	shiling
调处	tiaochu
杨树	yangshu
直通	zhitong
解说	jieshuo
持平	chiping
水池	shuichi
直面	zhimian
降级	jiangji
快餐	kuaican
年薪	nianxin
深秋	shenqiu
陈设	chenshe
反攻	fangong
旱情	hanqing
厚望	houwang
账目	zhangmu
邻邦	linbang
走遍	zoubian
回身	huishen
却说	queshuo
镰刀	liandao
手巾	shoujin
油料	youliao
公费	gongfei
果农	guonong
寄生	jisheng
推算	tuisuan
战备	zhanbei
带兵	daibing
烟尘	yanchen
动弹	dongtan
表白	biaobai
柔情	rouqing
烧毁	shaohui
水灾	shuizai
银杏	yinxing
火苗	huomiao
杨柳	yangliu
万千	wanqian
小偷	xiaotou
背诵	beisong
佛像	foxiang
行家	hangjia
分院	fenyuan
海浪	hailang
鸿沟	honggou
南宋	nansong
整日	zhengri
迟缓	chihuan
分娩	fenmian
掉头	diaotou
肝脏	ganzang
拐卖	guaimai
推断	tuiduan
候鸟	houniao
身价	shenjia
小看	xiaokan
辛酸	xinsuan
追加	zhuijia
参选	canxuan
纯属	chunshu
涵养	hanyang
裂缝	liefeng
前门	qianmen
骚动	saodong
编队	biandui
虫子	chongzi
订购	dinggou
家产	jiachan
血腥	xuexing
动心	dongxin
宁肯	ningken
文风	wenfeng
宴请	yanqing
埋藏	maicang
荣耀	rongyao
述说	shushuo
童谣	tongyao
标价	biaojia
裁减	caijian
分兵	fenbing
公车	gongche
军衔	junxian
清扫	qingsao
估量	guliang
算盘	suanpan
星球	xingqiu
落水	luoshui
糖果	tangguo
空难	kongnan
贫农	pinnong
容貌	rongmao
招考	zhaokao
好说	haoshuo
胆小	danxiao
配方	peifang
新潮	xinchao
展台	zhantai
先烈	xianlie
心动	xindong
靠拢	kaolong
扬言	yangyan
登载	dengzai
清早	qingzao
赏赐	shangci
水草	shuicao
推敲	tuiqiao
喧哗	xuanhua
坠毁	zhuihui
脚跟	jiaogen
病菌	bingjun
超群	chaoqun
丛林	conglin
社交	shejiao
着火	zhaohuo
慈祥	cixiang
牵制	qianzhi
掩映	yanying
不祥	buxiang
界面	jiemian
买方	maifang
猛进	mengjin
贪官	tanguan
外行	waihang
鼻梁	biliang
冲刺	chongci
草丛	caocong
盟友	mengyou
失守	shishou
体谅	tiliang
咆哮	paoxiao
都城	ducheng
飞天	feitian
工分	gongfen
鬼神	guishen
回旋	huixuan
狩猎	shoulie
背面	beimian
浓烈	nonglie
审问	shenwen
诗篇	shipian
闲暇	xianxia
缠绕	chanrao
手稿	shougao
病态	bingtai
菖蒲	changpu
神韵	shenyun
自重	zizhong
北边	beibian
名士	mingshi
要脸	yaolian
振作	zhenzuo
东家	dongjia
临行	linxing
枪击	qiangji
鼠标	shubiao
唯恐	weikong
暴行	baoxing
开明	kaiming
连带	liandai
应聘	yingpin
幽静	youjing
暴动	baodong
变态	biantai
沉醉	chenzui
淀粉	dianfen
动脉	dongmai
挥动	huidong
节电	jiedian
判刑	panxing
开销	kaixiao
硬盘	yingpan
分清	fenqing
高耸	gaosong
花瓶	huaping
叛乱	panluan
算数	suanshu
病因	bingyin
惨痛	cantong
脚印	jiaoyin
小鬼	xiaogui
硬化	yinghua
灌输	guanshu
接应	jieying
井下	jingxia
口水	koushui
内线	neixian
秋收	qiushou
听觉	tingjue
卓著	zhuozhu
白面	baimian
订婚	dinghun
洞穴	dongxue
机枪	jiqiang
下定	xiading
冲洗	chongxi
难听	nanting
修炼	xiulian
名贵	minggui
产后	chanhou
拍手	paishou
通货	tonghuo
货源	huoyuan
门缝	menfeng
善待	shandai
党群	dangqun
炼油	lianyou
年岁	niansui
连载	lianzai
盆景	penjing
全套	quantao
村寨	cunzhai
中国	zhongguo
生活	shenghuo
重要	zhongyao
成为	chengwei
方面	fangmian
学生	xuesheng
政治	zhengzhi
正在	zhengzai
城市	chengshi
上海	shanghai
非常	feichang
青年	qingnian
表现	biaoxian
群众	qunzhong
应当	yingdang
条件	tiaojian
环境	huanjing
正是	zhengshi
过程	guocheng
市场	shichang
完成	wancheng
首先	shouxian
行动	xingdong
相信	xiangxin
严重	yanzhong
说明	shuoming
共同	gongtong
中心	zhongxin
斗争	douzheng
造成	zaocheng
精神	jingshen
水平	shuiping
面前	mianqian
教授	jiaoshou
重新	chongxin
往往	wangwang
之中	zhizhong
总统	zongtong
文章	wenzhang
年轻	nianqing
始终	shizhong
电影	dianying
充分	chongfen
永远	yongyuan
标准	biaozhun
同样	tongyang
晚上	wanshang
明显	mingxian
粮食	liangshi
保证	baozheng
人生	rensheng
充满	chongman
等等	dengdeng
声音	shengyin
观念	guannian
经营	jingying
加强	jiaqiang
健康	jiankang
正确	zhengque
曾经	cengjing
专家	zhuanjia
重视	zhongshi
欢迎	huanying
质量	zhiliang
紧张	jinzhang
分钟	fenzhong
全面	quanmian
强烈	qianglie
手段	shouduan
讲话	jianghua
专门	zhuanmen
刚刚	ganggang
主张	zhuzhang
交通	jiaotong
关键	guanjian
承认	chengren
减少	jianshao
贡献	gongxian
对象	duixiang
宗教	zongjiao
表明	biaoming
成果	chengguo
卫生	weisheng
明天	mingtian
小说	xiaoshuo
广告	guanggao
当前	dangqian
当年	dangnian
财政	caizheng
广泛	guangfan
良好	lianghao
上来	shanglai
加上	jiashang
身边	shenbian
空间	kongjian
最终	zuizhong
商品	shangpin
走向	zouxiang
方便	fangbian
应用	yingyong
保障	baozhang
观点	guandian
功能	gongneng
成就	chengjiu
党员	dangyuan
尊重	zunzhong
构成	goucheng
典型	dianxing
生存	shengcun
方针	fangzhen
相对	xiangdui
生态	shengtai
中学	zhongxue
听说	tingshuo
年龄	nianling
照片	zhaopian
山东	shandong
尚未	shangwei
下降	xiajiang
数量	shuliang
多种	duozhong
好像	haoxiang
销售	xiaoshou
公共	gonggong
上述	shangshu
成熟	chengshu
将来	jianglai
承担	chengdan
成本	chengben
印象	yinxiang
推广	tuiguang
平衡	pingheng
正文	zhengwen
交换	jiaohuan
能源	nengyuan
品种	pinzhong
武装	wuzhuang
平等	pingdeng
挑战	tiaozhan
前面	qianmian
深深	shenshen
命令	mingling
朝鲜	chaoxian
官员	guanyuan
进程	jincheng
将军	jiangjun
情形	qingxing
申请	shenqing
软件	ruanjian
家长	jiazhang
渐渐	jianjian
交往	jiaowang
周年	zhounian
风险	fengxian
中华	zhonghua
完整	wanzheng
少年	shaonian
供应	gongying
注重	zhuzhong
众多	zhongduo
远远	yuanyuan
浙江	zhejiang
转化	zhuanhua
上下	shangxia
眼光	yanguang
愿望	yuanwang
健全	jianquan
种植	zhongzhi
坚定	jianding
官兵	guanbing
新疆	xinjiang
公园	gongyuan
春天	chuntian
队长	duichang
强化	qianghua
东方	dongfang
明年	mingnian
选手	xuanshou
房间	fangjian
见面	jianmian
调动	diaodong
政协	zhengxie
欣赏	xinshang
签订	qianding
表面	biaomian
服装	fuzhuang
公平	gongping
执政	zhizheng
整顿	zhengdun
家乡	jiaxiang
车辆	cheliang
动员	dongyuan
税收	shuishou
旁边	pangbian
小康	xiaokang
宏观	hongguan
民众	minzhong
锻炼	duanlian
轻松	qingsong
前景	qianjing
杭州	hangzhou
乡村	xiangcun
听见	tingjian
影片	yingpian
成都	chengdou
场所	changsuo
前往	qianwang
优良	youliang
青春	qingchun
辉煌	huihuang
营养	yingyang
上市	shangshi
剩下	shengxia
平静	pingjing
减轻	jianqing
会长	huichang
创业	chuangye
含量	hanliang
广阔	guangkuo
承诺	chengnuo
常委	changwei
承包	chengbao
鲜明	xianming
中外	zhongwai
网站	wangzhan
监管	jianguan
相反	xiangfan
协商	xieshang
天空	tiankong
下乡	xiaxiang
增收	zengshou
航空	hangkong
煤矿	meikuang
赔偿	peichang
出生	chusheng
纠正	jiuzheng
成分	chengfen
江南	jiangnan
产权	chanquan
中文	zhongwen
上学	shangxue
情景	qingjing
教练	jiaolian
员工	yuangong
东京	dongjing
调控	tiaokong
崇高	chonggao
振兴	zhenxing
纵横	zongheng
支撑	zhicheng
原料	yuanliao
沈阳	shenyang
安装	anzhuang
诞生	dansheng
海上	haishang
冬天	dongtian
弘扬	hongyang
全年	quannian
悄悄	qiaoqiao
占领	zhanling
校园	xiaoyuan
表情	biaoqing
辽宁	liaoning
同情	tongqing
上班	shangban
高中	gaozhong
赞成	zancheng
天天	tiantian
框架	kuangjia
称号	chenghao
聪明	congming
风景	fengjing
效应	xiaoying
当选	dangxuan
着手	zhuoshou
从前	congqian
正好	zhenghao
航天	hangtian
统筹	tongchou
东盟	dongmeng
联盟	lianmeng
关怀	guanhuai
评选	pingxuan
长沙	changsha
证书	zhengshu
封建	fengjian
健身	jianshen
黄金	huangjin
认证	renzheng
领先	lingxian
演讲	yanjiang
光辉	guanghui
外商	waishang
尽量	jinliang
招标	zhaobiao
奠定	dianding
展现	zhanxian
党建	dangjian
政委	zhengwei
众人	zhongren
倡导	changdao
诚信	chengxin
睡觉	shuijiao
联邦	lianbang
事项	shixiang
党风	dangfeng
建交	jianjiao
赞赏	zanshang
洪水	hongshui
讲究	jiangjiu
享有	xiangyou
中介	zhongjie
笑容	xiaorong
处长	chuchang
抢救	qiangjiu
性能	xingneng
征求	zhengqiu
经典	jingdian
动手	dongshou
全身	quanshen
周边	zhoubian
边境	bianjing
垄断	longduan
神经	shenjing
早上	zaoshang
论证	lunzheng
匆匆	congcong
现行	xianxing
公顷	gongqing
抗战	kangzhan
消防	xiaofang
从小	congxiao
警方	jingfang
争夺	zhengduo
高尚	gaoshang
导向	daoxiang
初中	chuzhong
磋商	cuoshang
放松	fangsong
之上	zhishang
连忙	lianmang
壮大	zhuangda
充实	chongshi
称赞	chengzan
冷静	lengjing
纲领	gangling
诊断	zhenduan
明星	mingxing
上门	shangmen
平原	pingyuan
整改	zhenggai
顽强	wanqiang
班长	banchang
深远	shenyuan
尝试	changshi
院校	yuanxiao
设想	shexiang
水面	shuimian
边防	bianfang
延长	yanchang
承办	chengban
乡亲	xiangqin
帮忙	bangmang
增产	zengchan
凌晨	lingchen
农田	nongtian
年前	nianqian
强制	qiangzhi
姓名	xingming
深受	shenshou
涌现	yongxian
面孔	miankong
命名	mingming
厂家	changjia
奖金	jiangjin
师生	shisheng
营销	yingxiao
讲座	jiangzuo
伤心	shangxin
授权	shouquan
景观	jingguan
月亮	yueliang
捐款	juankuan
种类	zhonglei
层面	cengmian
反响	fanxiang
扩张	kuozhang
讲述	jiangshu
捐赠	juanzeng
将士	jiangshi
焦点	jiaodian
关税	guanshui
反正	fanzheng
台上	taishang
攻关	gongguan
兴建	xingjian
监控	jiankong
心想	xinxiang
零售	lingshou
好转	haozhuan
通用	tongyong
拆迁	chaiqian
肩膀	jianbang
小型	xiaoxing
时尚	shishang
增添	zengtian
交警	jiaojing
窗户	chuanghu
挣扎	zhengzha
商人	shangren
丰收	fengshou
缓缓	huanhuan
乡下	xiangxia
争论	zhenglun
运转	yunzhuan
飞船	feichuan
元首	yuanshou
经受	jingshou
身影	shenying
赶上	ganshang
中旬	zhongxun
倾销	qingxiao
再生	zaisheng
总算	zongsuan
获奖	huojiang
同行	tonghang
先锋	xianfeng
原先	yuanxian
空前	kongqian
赛场	saichang
条款	tiaokuan
强国	qiangguo
商家	shangjia
变动	biandong
况且	kuangqie
空调	kongtiao
病情	bingqing
电网	dianwang
水源	shuiyuan
皇后	huanghou
党校	dangxiao
长久	changjiu
漫长	manchang
榜样	bangyang
向着	xiangzhe
光彩	guangcai
山水	shanshui
投降	touxiang
上游	shangyou
主场	zhuchang
同年	tongnian
倾听	qingting
多项	duoxiang
形容	xingrong
官方	guanfang
新生	xinsheng
南昌	nanchang
规章	guizhang
连连	lianlian
偏偏	pianpian
时光	shiguang
债券	zhaiquan
供水	gongshui
朝廷	chaoting
真情	zhenqing
清晨	qingchen
黄昏	huanghun
节省	jiesheng
痛快	tongkuai
常规	changgui
震惊	zhenjing
赠送	zengsong
创立	chuangli
加重	jiazhong
边缘	bianyuan
考生	kaosheng
流传	liuchuan
师长	shizhang
病房	bingfang
占用	zhanyong
改正	gaizheng
收藏	shoucang
香烟	xiangyan
竞选	jingxuan
瞬间	shunjian
水电	shuidian
上台	shangtai
在场	zaichang
邮政	youzheng
良心	liangxin
通行	tongxing
崇拜	chongbai
挑选	tiaoxuan
田径	tianjing
风情	fengqing
缅甸	miandian
教员	jiaoyuan
奉行	fengxing
传输	chuanshu
公交	gongjiao
违章	weizhang
闪烁	shanshuo
仲裁	zhongcai
党性	dangxing
东风	dongfeng
相处	xiangchu
月光	yueguang
前线	qianxian
银川	yinchuan
内政	neizheng
供电	gongdian
抢劫	qiangjie
贫穷	pinqiong
显现	xianxian
签名	qianming
正月	zhengyue
聊天	liaotian
从容	congrong
点评	dianping
分成	fencheng
疼痛	tengtong
林场	linchang
登山	dengshan
撰写	zhuanxie
教堂	jiaotang
永恒	yongheng
年产	nianchan
向来	xianglai
扭转	niuzhuan
震动	zhendong
颁奖	banjiang
先前	xianqian
防守	fangshou
中队	zhongdui
变更	biangeng
分量	fenliang
评审	pingshen
上演	shangyan
攻坚	gongjian
天真	tianzhen
往年	wangnian
电站	dianzhan
传媒	chuanmei
年间	nianjian
定点	dingdian
省份	shengfen
讲解	jiangjie
宁静	ningjing
牲畜	shengchu
顺应	shunying
展望	zhanwang
航线	hangxian
春风	chunfeng
掌柜	zhanggui
片面	pianmian
回升	huisheng
年年	niannian
照样	zhaoyang
敞开	changkai
网点	wangdian
寿命	shouming
电灯	diandeng
怀念	huainian
转阴	zhuanyin
车厢	chexiang
盛会	shenghui
水准	shuizhun
将要	jiangyao
繁重	fanzhong
降价	jiangjia
乘坐	chengzuo
源泉	yuanquan
抗洪	kanghong
兼并	jianbing
天堂	tiantang
公款	gongkuan
储量	chuliang
当面	dangmian
惩治	chengzhi
田间	tianjian
平方	pingfang
肿瘤	zhongliu
冷笑	lengxiao
阵容	zhenrong
获胜	huosheng
同等	tongdeng
改良	gailiang
硬件	yingjian
变迁	bianqian
更换	genghuan
联网	lianwang
起床	qichuang
动荡	dongdang
通关	tongguan
明朝	mingzhao
酝酿	yunniang
平壤	pingrang
联手	lianshou
村长	cunchang
兵团	bingtuan
行径	xingjing
笼罩	longzhao
正规	zhenggui
民政	minzheng
曝光	baoguang
春耕	chungeng
情愿	qingyuan
稍稍	shaoshao
雄厚	xionghou
诚恳	chengken
分享	fenxiang
成才	chengcai
专职	zhuanzhi
市政	shizheng
税款	shuikuan
神仙	shenxian
朦胧	menglong
抽调	choudiao
练兵	lianbing
夸张	kuazhang
前方	qianfang
巧妙	qiaomiao
转为	zhuanwei
坚守	jianshou
穷人	qiongren
远方	yuanfang
选票	xuanpiao
光盘	guangpan
全线	quanxian
丰硕	fengshuo
精简	jingjian
商贸	shangmao
瞄准	miaozhun
献身	xianshen
堪称	kancheng
老将	laojiang
上报	shangbao
收缴	shoujiao
情怀	qinghuai
通往	tongwang
由衷	youzhong
名片	mingpian
高声	gaosheng
老乡	laoxiang
前年	qiannian
评定	pingding
超标	chaobiao
衰退	shuaitui
升华	shenghua
星星	xingxing
阐明	chanming
船只	chuanzhi
防洪	fanghong
效能	xiaoneng
水产	shuichan
高涨	gaozhang
放宽	fangkuan
动用	dongyong
专栏	zhuanlan
商会	shanghui
茫茫	mangmang
看重	kanzhong
防线	fangxian
生殖	shengzhi
浪潮	langchao
重返	zhongfan
用工	yonggong
前边	qianbian
关联	guanlian
当真	dangzhen
寻常	xunchang
深沉	shenchen
流程	liucheng
新娘	xinniang
窗子	chuangzi
顺手	shunshou
阵阵	zhenzhen
相差	xiangcha
招收	zhaoshou
断定	duanding
选用	xuanyong
送行	songxing
谅解	liangjie
惊醒	jingxing
相识	xiangshi
官僚	guanliao
山顶	shanding
笑脸	xiaolian
花生	huasheng
损伤	sunshang
表扬	biaoyang
总共	zonggong
请教	qingjiao
钟头	zhongtou
娘家	niangjia
降落	jiangluo
王朝	wangchao
审定	shending
能手	nengshou
冷战	lengzhan
航行	hangxing
统领	tongling
嘲笑	chaoxiao
青山	qingshan
过剩	guosheng
神州	shenzhou
庆典	qingdian
放映	fangying
宽松	kuansong
钞票	chaopiao
修正	xiuzheng
猜想	caixiang
性情	xingqing
宽容	kuanrong
连年	liannian
有偿	youchang
摘编	zhaibian
穿越	chuanyue
手工	shougong
构想	gouxiang
伤口	shangkou
乘车	chengche
流量	liuliang
传染	chuanran
欢快	huankuai
惩处	chengchu
轮船	lunchuan
平面	pingmian
回想	huixiang
统统	tongtong
动情	dongqing
宣扬	xuanyang
奉命	fengming
专人	zhuanren
通红	tonghong
上街	shangjie
严惩	yancheng
变形	bianxing
标兵	biaobing
草场	caochang
功臣	gongchen
相近	xiangjin
拯救	zhengjiu
筛选	shaixuan
停产	tingchan
轰动	hongdong
未尝	weichang
跳动	tiaodong
沉着	chenzhuo
少见	shaojian
城门	chengmen
迎面	yingmian
奖牌	jiangpai
当兵	dangbing
整洁	zhengjie
选定	xuanding
常驻	changzhu
筹建	choujian
出征	chuzheng
闪闪	shanshan
验证	yanzheng
围墙	weiqiang
追踪	zhuizong
猖獗	changjue
电源	dianyuan
北上	beishang
流转	liuzhuan
成败	chengbai
顺便	shunbian
壮丽	zhuangli
单项	danxiang
跳水	tiaoshui
正派	zhengpai
降临	jianglin
清算	qingsuan
供销	gongxiao
曙光	shuguang
终究	zhongjiu
噪声	zaosheng
手表	shoubiao
西装	xizhuang
落成	luocheng
上旬	shangxun
收受	shoushou
疗效	liaoxiao
火光	huoguang
昆虫	kunchong
前行	qianxing
身亡	shenwang
苍蝇	cangying
碰见	pengjian
平行	pingxing
当天	dangtian
团员	tuanyuan
庭院	tingyuan
连同	liantong
照料	zhaoliao
公用	gongyong
脸红	lianhong
产销	chanxiao
流向	liuxiang
偏见	pianjian
照明	zhaoming
号称	haocheng
迎春	yingchun
前天	qiantian
量化	lianghua
牵动	qiandong
捐献	juanxian
房产	fangchan
缅怀	mianhuai
专著	zhuanzhu
树种	shuzhong
应酬	yingchou
原定	yuanding
偏远	pianyuan
攀升	pansheng
防空	fangkong
侥幸	jiaoxing
旁听	pangting
共鸣	gongming
沧桑	cangsang
民生	minsheng
精明	jingming
同盟	tongmeng
转折	zhuanzhe
央行	yanghang
线条	xiantiao
灯笼	denglong
深层	shenceng
望见	wangjian
庄子	zhuangzi
军政	junzheng
陷阱	xianjing
联欢	lianhuan
兴旺	xingwang
下场	xiachang
珠江	zhujiang
品尝	pinchang
吊销	diaoxiao
空洞	kongdong
飘扬	piaoyang
前锋	qianfeng
变换	bianhuan
动身	dongshen
迎战	yingzhan
交锋	jiaofeng
通风	tongfeng
讲台	jiangtai
恐龙	konglong
生猪	shengzhu
接种	jiezhong
为重	weizhong
贯通	guantong
男生	nansheng
闪电	shandian
眼眶	yankuang
关照	guanzhao
动工	donggong
涨价	zhangjia
工钱	gongqian
减产	jianchan
劝说	quanshuo
恒星	hengxing
伤感	shanggan
牲口	shengkou
创意	chuangyi
荧屏	yingping
飞翔	feixiang
胸口	xiongkou
害虫	haichong
标签	biaoqian
惊动	jingdong
开枪	kaiqiang
匆忙	congmang
皇家	huangjia
梦见	mengjian
圣人	shengren
小鸟	xiaoniao
强盗	qiangdao
感想	ganxiang
邦交	bangjiao
忘掉	wangdiao
坦诚	tancheng
颤动	chandong
画像	huaxiang
涌动	yongdong
间断	jianduan
承载	chengzai
电动	diandong
工农	gongnong
纵深	zongshen
宫廷	gongting
首领	shouling
沉痛	chentong
晋升	jinsheng
精通	jingtong
鲜红	xianhong
风浪	fenglang
经销	jingxiao
长叹	changtan
联名	lianming
聆听	lingting
通电	tongdian
患病	huanbing
坦率	tanshuai
精湛	jingzhan
撞击	zhuangji
宁愿	ningyuan
天性	tianxing
超前	chaoqian
面容	mianrong
听从	tingcong
摇晃	yaohuang
冰冷	bingleng
采矿	caikuang
深山	shenshan
点缀	dianzhui
香味	xiangwei
正要	zhengyao
受骗	shoupian
长处	changchu
规程	guicheng
上头	shangtou
前身	qianshen
荡荡	dangdang
全权	quanquan
展厅	zhanting
梦幻	menghuan
镇定	zhending
家政	jiazheng
谎言	huangyan
泉水	quanshui
潜艇	qianting
印章	yinzhang
手绢	shoujuan
衰老	shuailao
房东	fangdong
雄伟	xiongwei
盛开	shengkai
行情	hangqing
专版	zhuanban
朝阳	chaoyang
链条	liantiao
统战	tongzhan
元年	yuannian
宰相	zaixiang
双打	shuangda
常人	changren
舰艇	jianting
年限	nianxian
中秋	zhongqiu
教养	jiaoyang
勋章	xunzhang
考证	kaozheng
考场	kaochang
看上	kanshang
衬衫	chenshan
厚重	houzhong
金奖	jinjiang
还原	huanyuan
存量	cunliang
相邻	xianglin
穿梭	chuansuo
欢庆	huanqing
沉淀	chendian
光滑	guanghua
坚硬	jianying
相貌	xiangmao
粮油	liangyou
作声	zuosheng
成套	chengtao
面条	miantiao
流畅	liuchang
圆形	yuanxing
真空	zhenkong
指向	zhixiang
并肩	bingjian
讲求	jiangqiu
唤醒	huanxing
电线	dianxian
红灯	hongdeng
声势	shengshi
朗诵	langsong
拱手	gongshou
斩首	zhanshou
总监	zongjian
乖乖	guaiguai
停电	tingdian
沉静	chenjing
售票	shoupiao
观望	guanwang
参政	canzheng
升温	shengwen
珍藏	zhencang
过重	guozhong
球场	qiuchang
山羊	shanyang
情调	qingdiao
等同	dengtong
良知	liangzhi
限定	xianding
作证	zuozheng
开张	kaizhang
惊恐	jingkong
铜钱	tongqian
战乱	zhanluan
阵线	zhenxian
见效	jianxiao
田园	tianyuan
忧伤	youshang
荡漾	dangyang
讲演	jiangyan
冷暖	lengnuan
商讨	shangtao
种群	zhongqun
张贴	zhangtie
远东	yuandong
开场	kaichang
增效	zengxiao
挣脱	zhengtuo
悬念	xuannian
黄瓜	huanggua
明朗	minglang
东边	dongbian
口腔	kouqiang
相待	xiangdai
高梁	gaoliang
毫升	haosheng
总管	zongguan
后生	housheng
勤政	qinzheng
天明	tianming
票房	piaofang
平平	pingping
伤残	shangcan
冷水	lengshui
幼虫	youchong
重托	zhongtuo
全能	quanneng
长辈	zhangbei
供养	gongyang
降温	jiangwen
召见	zhaojian
面料	mianliao
封面	fengmian
壮举	zhuangju
瞧见	qiaojian
天桥	tianqiao
转轨	zhuangui
机床	jichuang
交融	jiaorong
农用	nongyong
应变	yingbian
本省	bensheng
零星	lingxing
著称	zhucheng
清明	qingming
伤痕	shanghen
险情	xianqing
转眼	zhuanyan
讲学	jiangxue
广为	guangwei
交战	jiaozhan
侨眷	qiaojuan
英明	yingming
精兵	jingbing
夸奖	kuajiang
首选	shouxuan
交情	jiaoqing
重担	zhongdan
成品	chengpin
贵重	guizhong
诚然	chengran
向导	xiangdao
组装	zuzhuang
作响	zuoxiang
天线	tianxian
全员	quanyuan
成群	chengqun
共性	gongxing
零件	lingjian
砖头	zhuantou
桌面	zhuomian
脸庞	lianpang
减缓	jianhuan
隆隆	longlong
惊叫	jingjiao
用兵	yongbing
踪影	zongying
潜能	qianneng
平庸	pingyong
明了	mingliao
印证	yinzheng
舒畅	shuchang
殿堂	diantang
倔强	juejiang
梦境	mengjing
商谈	shangtan
方圆	fangyuan
纵容	zongrong
减税	jianshui
荣幸	rongxing
潮水	chaoshui
惯性	guanxing
援建	yuanjian
乐章	yuezhang
证人	zhengren
充斥	chongchi
恭敬	gongjing
张罗	zhangluo
山峰	shanfeng
听差	tingchai
亲生	qinsheng
消遣	xiaoqian
召唤	zhaohuan
专心	zhuanxin
承接	chengjie
惨重	canzhong
胆量	danliang
列强	lieqiang
联营	lianying
张嘴	zhangzui
供奉	gongfeng
谋生	mousheng
收敛	shoulian
整修	zhengxiu
简便	jianbian
相伴	xiangban
纸张	zhizhang
华中	huazhong
升学	shengxue
口粮	kouliang
嚷嚷	rangrang
冒充	maochong
光缆	guanglan
相看	xiangkan
断面	duanmian
猛增	mengzeng
招工	zhaogong
喧嚣	xuanxiao
编纂	bianzuan
称道	chengdao
浇水	jiaoshui
人称	rencheng
兄妹	xiongmei
表层	biaoceng
开荒	kaihuang
旋风	xuanfeng
练功	liangong
重叠	chongdie
脸孔	liankong
沉沉	chenchen
中南	zhongnan
酱油	jiangyou
纯净	chunjing
水田	shuitian
眺望	tiaowang
榜首	bangshou
扩充	kuochong
传单	chuandan
相约	xiangyue
电工	diangong
动乱	dongluan
动听	dongting
推崇	tuichong
算命	suanming
河床	hechuang
转告	zhuangao
长跑	changpao
刑侦	xingzhen
风水	fengshui
管教	guanjiao
金黄	jinhuang
仰望	yangwang
尚且	shangqie
烧饼	shaobing
重演	chongyan
水晶	shuijing
政坛	zhengtan
灵通	lingtong
定性	dingxing
声道	shengdao
线段	xianduan
船闸	chuanzha
春联	chunlian
老兄	laoxiong
周旋	zhouxuan
到场	daochang
脸面	lianmian
轻盈	qingying
闪现	shanxian
迎风	yingfeng
性病	xingbing
名堂	mingtang
轻快	qingkuai
万象	wanxiang
声乐	shengyue
抽签	chouqian
电能	dianneng
影院	yingyuan
鸳鸯	yuanyang
龙舟	longzhou
臭氧	chouyang
远景	yuanjing
欢笑	huanxiao
变色	bianshai
催生	cuisheng
黄海	huanghai
过量	guoliang
食粮	shiliang
写生	xiesheng
衰落	shuailuo
王宫	wanggong
山寨	shanzhai
堂堂	tangtang
荒谬	huangmiu
现年	xiannian
哼哼	hengheng
冷清	lengqing
创举	chuangju
先天	xiantian
成因	chengyin
光阴	guangyin
收容	shourong
黄牛	huangniu
心肠	xinchang
阵营	zhenying
双目	shuangmu
穿戴	chuandai
放行	fangxing
牵连	qianlian
晴朗	qinglang
上进	shangjin
相会	xianghui
全景	quanjing
方桌	fangzhuo
天边	tianbian
应从	yingcong
诊疗	zhenliao
红星	hongxing
管用	guanyong
精巧	jingqiao
飘荡	piaodang
东洋	dongyang
清风	qingfeng
精灵	jingling
满腔	manqiang
传闻	chuanwen
艰险	jianxian
绵绵	mianmian
免收	mianshou
抗衡	kangheng
晴天	qingtian
抢修	qiangxiu
蒙受	mengshou
怂恿	songyong
兴隆	xinglong
胸襟	xiongjin
点名	dianming
黄沙	huangsha
干粮	ganliang
欠款	qiankuan
商贩	shangfan
宣战	xuanzhan
冠名	guanming
宦官	huanguan
病变	bingbian
渺茫	miaomang
栽种	zaizhong
张口	zhangkou
管线	guanxian
苍茫	cangmang
青铜	qingtong
书生	shusheng
有成	youcheng
持枪	chiqiang
鸣放	mingfang
月中	yuezhong
敬献	jingxian
临终	linzhong
消亡	xiaowang
萧条	xiaotiao
酋长	qiuzhang
手软	shouruan
纯真	chunzhen
评点	pingdian
城楼	chenglou
防病	fangbing
风潮	fengchao
神灵	shenling
女双	nvshuang
睁眼	zhengyan
驰骋	chicheng
水桶	shuitong
顺从	shuncong
主帅	zhushuai
良久	liangjiu
并用	bingyong
免税	mianshui
脏病	zangbing
胶囊	jiaonang
相持	xiangchi
联防	lianfang
评说	pingshuo
长者	zhangzhe
伸展	shenzhan
老娘	laoniang
中游	zhongyou
胜过	shengguo
心胸	xinxiong
周身	zhoushen
专列	zhuanlie
充沛	chongpei
枪口	qiangkou
说教	shuojiao
明快	mingkuai
战前	zhanqian
争斗	zhengdou
街巷	jiexiang
天平	tianping
孝敬	xiaojing
更名	gengming
壮族	zhuangzu
祥云	xiangyun
领空	lingkong
总产	zongchan
说笑	shuoxiao
港元	gangyuan
震荡	zhendang
沉睡	chenshui
强者	qiangzhe
生根	shenggen
宪兵	xianbing
粗壮	cuzhuang
反常	fanchang
实况	shikuang
房顶	fangding
光临	guanglin
焦灼	jiaozhuo
